--- TELEGRAM: DREAMPIUV ---
--- TELEGRAM CHANNEL: ENGLISHAFL
--- DNE ---

abide: uymak, katlanmak, riayet etmek
abolished: kaldırılmış, feshedilmiş, ilga edilmiş
abolition: kaldırma, feshetme, ilga
abrupt: ani, birdenbire, apansız
abstains: çekimser kalır, kaçınır, sakınır
abundance: bolluk, çokluk, bereket
abundant: bol, çok, bereketli
abuse: kötüye kullanma, istismar, taciz
academic: akademik
accelerated: hızlandırılmış, ivmelendirilmiş
accelerates: hızlandırır, ivmelendirir
access: erişim, giriş, ulaşım
accessible: erişilebilir, ulaşılabilir, girilebilir
accommodate: yerleştirmek, barındırmak, uyum sağlamak
accomplished: başarılı, yetenekli, tamamlanmış
accomplishments: başarılar, hünerler, kazanımlar
accompany: eşlik etmek, refakat etmek
accompanied: eşliğinde, refakatinde, -nın eşlik ettiği
accordingly: ona göre, bu doğrultuda, dolayısıyla
accountability: hesap verebilirlik, sorumluluk
accumulated: birikmiş, toplanmış
accuracy: doğruluk, kesinlik, hassasiyet
accurately: doğru bir şekilde, kesin olarak
accusations: suçlamalar, ithamlar
achievement: başarı, kazanım
acknowledge: kabul etmek, tanımak, bildirmek
acquired: edinilmiş, kazanılmış
acquisition: edinme, kazanım, iktisap
activated: aktive edilmiş, etkinleştirilmiş
adaptation: uyum, adaptasyon, uyarlama
addiction: bağımlılık
addictive: bağımlılık yapan
adequate: yeterli, kafi, uygun
adequately: yeterince, yeterli derecede
adherence: bağlılık, (kurala) uyma, sadakat
adhering: bağlı kalan, uyan, yapışan
administered: yönetilen, idare edilen, (ilaç) verilen
admirably: takdire şayan bir şekilde, hayranlık uyandıracak biçimde
admired: hayran olunan, beğenilen, takdir edilen
admirers: hayranlar, takdir edenler
admission: kabul, giriş, itiraf
admitted: kabul edilmiş, itiraf edilmiş
admittedly: kabul etmek gerekir ki, itiraf etmek gerekirse
adolescence: ergenlik, gençlik çağı
adolescents: ergenler, gençler
adopt: benimsemek, evlat edinmek, kabul etmek
adopted: benimsenmiş, evlat edinilmiş
adorned: süslenmiş, bezenmiş
adulthood: yetişkinlik
advances: ilerlemeler, gelişmeler, avanslar
advent: geliş, ortaya çıkış, zuhur
adversary: rakip, düşman, hasım
adverse: ters, olumsuz, aksi, muhalif
adversely: olumsuz şekilde, tersine, aleyhte
advocates: savunucular, destekçiler (noun), savunur (verb)
advocated: savunulan, desteklenen
aerodynamics: aerodinamik
aerobic: aerobik, oksijenli
aesthetic: estetik
aesthetically: estetik olarak, estetik açıdan
affairs: işler, meseleler, ilişkiler
affinity: yakınlık, ilgi, eğilim, afinite
affirm: onaylamak, doğrulamak, teyit etmek
affluence: refah, zenginlik, bolluk
afflicted: muzdarip, etkilenmiş, dertli
affront: hakaret, aşağılama, saygısızlık
aggression: saldırganlık, tecavüzkarlık
agile: çevik, atik, kıvrak
agility: çeviklik, atiklik, kıvraklık
agitation: huzursuzluk, kışkırtma, çalkalama, ajitasyon
ailments: rahatsızlıklar, hastalıklar
akin: yakın, benzer (-e yakın)
albeit: rağmen, gerçi, ise de
alchemy: simya
alchemists: simyacılar
alertness: uyanıklık, tetikte olma hali
algae: algler, yosunlar
alienating: yabancılaştıran, soğutan
alignment: hizalama, aynı hizaya getirme, uyum, ittifak
alleviate: hafifletmek, dindirmek, azaltmak
alleviating: hafifleten, dindiren
alliances: ittifaklar, birlikler
allocated: tahsis edilmiş, ayrılmış
alloy: alaşım
allude: ima etmek, değinmek, üstü kapalı söylemek
ally: müttefik, dost
alter: değiştirmek, başkalaştırmak
altered: değiştirilmiş, değişmiş
alternative: alternatif, seçenek, diğer
alternatively: alternatif olarak, başka bir seçenek olarak
altitude: irtifa, yükseklik (deniz seviyesinden)
amalgamating: birleştiren, kaynaştıran
amateur: amatör, acemi
ambiguity: belirsizlik, muğlaklık, anlam bulanıklığı
ambiguous: belirsiz, muğlak, çok anlamlı
ambiguously: belirsiz bir şekilde, muğlakça
amelogenin: amelogenin (diş minesi proteini)
amendments: değişiklikler, düzeltmeler, tadiller (genellikle yasa)
amid: ortasında, arasında (-in ortasında)
ample: bol, yeterli, geniş
amplified: güçlendirilmiş, artırılmış, yükseltilmiş (ses vb.)
amplifies: güçlendirir, artırır, yükseltir
amputated: kesilmiş, ampute edilmiş (uzuv)
amputees: ampüteler, uzvu kesilmiş kişiler
analogy: analoji, benzetme, örnekseme
anatomy: anatomi
ancestors: atalar, cedler
ancestry: soy, köken, nesep
anecdotally: anekdot kabilinden, duyuma göre, rivayete göre
anguish: şiddetli acı, ıstırap, keder
animated: canlı, hareketli, canlandırılmış (çizgi film vb.)
animosity: düşmanlık, kin, husumet
annexation: ilhak, (toprak) katma
annihilation: yok etme, imha, ortadan kaldırma
annoyance: rahatsızlık, sıkıntı, sinir bozucu durum/şey
anomalous: anormal, kural dışı, aykırı
anonymously: anonim olarak, isimsiz bir şekilde
antagonism: düşmanlık, karşıtlık, antagonizma
antecedents: öncüller, sebepler, geçmiş olaylar, atalar
anthropologists: antropologlar, insan bilimciler
anticipated: beklenen, umulan, öngörülen
antiquity: antik çağ, eski çağlar, eskilik
antithesis: antitez, karşı sav, zıtlık
anxiety: kaygı, endişe, anksiyete
anxiously: endişeyle, kaygıyla
apartheid: apartheid, ırk ayrımcılığı rejimi
aperture: açıklık, aralık, delik (özellikle optik)
apparatus: aygıt, cihaz, donanım, düzenek
apparent: açık, belli, bariz, görünürdeki
apparently: görünüşe göre, anlaşılan, görünüşte
appealing: çekici, cazip, hoş
appearance: görünüş, dış görünüm, ortaya çıkma
appreciation: takdir, minnettarlık, değerini bilme, değer artışı
appreciative: minnettar, takdir eden
apprehension: endişe, kaygı, korku, kavrayış, yakalama, tutuklama
apprenticeship: çıraklık, stajyerlik
approach: yaklaşım, yöntem, yaklaşma
appropriately: uygun bir şekilde, yerinde olarak
approval: onay, tasvip, izin
approximate: yaklaşık, tahmini
aptitude: yetenek, kabiliyet, eğilim
arbitrarily: keyfi olarak, gelişigüzel, rastgele
arbitrary: keyfi, rastgele, nedensiz
archaic: arkaik, çok eski, modası geçmiş
archaeological: arkeolojik
archaeology: arkeoloji, kazıbilim
archetypal: arketipsel, ilk örneğe ait, prototipik
architecture: mimari, mimarlık
arid: kurak, çorak
aristocrats: aristokratlar, soylular
armory: silah deposu, cephanelik, zırh (eski anlam)
aromas: aromalar, hoş kokular
aroused: uyarılmış, harekete geçirilmiş, tahrik edilmiş
artefacts: insan yapımı nesneler, tarihi eserler, yapıtlar
articulates: açıkça ifade eder, dile getirir, eklemler (verb)
artificial: yapay, suni
artificially: yapay olarak, suni olarak
ascendancy: üstünlük, egemenlik, hakimiyet
ascertain: tespit etmek, belirlemek, doğruluğunu anlamak
ascribed: atfedilen, isnat edilen, -e yorulan
aspiration: güçlü arzu, özlem, hedef, emel
aspiring: hevesli, (-meye) can atan, aday
assemble: bir araya getirmek, toplamak, monte etmek
assert: iddia etmek, ileri sürmek, belirtmek
asserting: iddia ederek, ileri sürerek
assertion: iddia, sav, beyan
assertiveness: kendinden eminlik, girişkenlik, iddiacılık
assessment: değerlendirme, tespit, paha biçme
assessment: değerlendirme, tespit, paha biçme
assimilate: özümsemek, benimsemek, asimile etmek/olmak
assimilated: özümsenmiş, benimsenmiş, asimile edilmiş/olmuş
assimilation: özümseme, asimilasyon, benzeşme
association: ilişki, bağlantı, dernek, birlik, çağrışım
assumptions: varsayımlar, faraziyeler
assurance: güvence, teminat, söz, kendine güven
astonished: şaşkın, hayrete düşmüş
astronomers: astronomlar, gökbilimciler
astronomical: astronomik, gökbilimsel, çok büyük, fahiş (mecazi)
asymmetrical: asimetrik, bakışımsız
atheism: ateizm, tanrıtanımazlık
at odds with: ile anlaşmazlık içinde, ile çelişen, -e ters düşen
at stake: tehlikede, risk altında, söz konusu olan
attains: ulaşır, elde eder, erişir
attainable: ulaşılabilir, erişilebilir, elde edilebilir
attendance: katılım, devam, hazır bulunma
attentive: dikkatli, özenli, ilgili
attest: doğrulamak, kanıtlamak, tanıklık etmek (-e)
attorney: avukat, vekil, temsilci
attraction: çekim, cazibe, çekicilik, turistik yer
attributes: nitelikler, özellikler, vasıflar (noun), atfeder, yorar (verb)
auctions: açık artırmalar, müzayedeler
auditory: işitsel, duyma ile ilgili
auspicious: uğurlu, hayırlı, iyiye işaret
authenticity: özgünlük, gerçeklik, sahihlik
authoritarian: otoriter, baskıcı
authorities: yetkililer, makamlar, otoriteler
autism: otizm
autobiographies: otobiyografiler, öz yaşam öyküleri
automated: otomatikleştirilmiş, otomatik hale getirilmiş
automatically: otomatik olarak, kendiliğinden
autonomous: otonom, özerk
autonomously: otonom olarak, özerk bir şekilde
autonomy: otonomi, özerklik
availability: bulunabilirlik, mevcut olma, müsaitlik
available: mevcut, uygun, müsait, elde edilebilir
avalanche: çığ
avarice: açgözlülük, hırs (para/mal)
aversion: hoşnutsuzluk, tiksinme, isteksizlik
aviation: havacılık
aviators: havacılar, pilotlar
avoidance: kaçınma, sakınma
awe: huşu, derin saygı, korkuyla karışık hayranlık
awkward: garip, tuhaf, sakar, biçimsiz
axiomatic: aksiyomatik, doğruluğu apaçık
axis: eksen, mihver
babble: gevezelik etmek, saçmalamak
backfire: geri tepmek, ters etki yapmak
backstories: arka plan hikayeleri
backup: yedek, destek
banned: yasaklanmış, men edilmiş
barbaric: barbar, vahşi
bargaining: pazarlık yapma, pazarlık
barriers: engeller, bariyerler
basalt: bazalt
biased: önyargılı, taraflı
bibliography: bibliyografya, kaynakça
bilingualism: iki dillilik
biochemistry: biyokimya
biodiversity: biyoçeşitlilik, biyolojik çeşitlilik
biogeography: biyocoğrafya
biological: biyolojik
biologically: biyolojik olarak
biomedical: biyomedikal, biyotıp
bipartisan: iki partili, partiler üstü
blame: suçlamak, kabahat bulmak
bleaching: ağartma, beyazlatma, renk kaybı (mercan vb.)
blend: karıştırmak, harmanlamak, karışım
blight: afet, bitki hastalığı, karartmak, kötü etkilemek
blinking: göz kırpma, yanıp sönme
bloated: şişkin, şişmiş
blocks: bloklar, kütleler, engeller
blobs: lekeler, damlalar, şekilsiz kütleler
blooming: çiçek açan, gelişen, serpilmekte olan
blossomed: çiçek açmış, gelişmiş, serpilmiş
blunder: büyük hata, gaf, pot kırmak
blunt: kör, keskin olmayan, küt, dobra, açık sözlü
blurred: bulanık, flu, belirsiz
blushing: kızarma, yüzü kızarma
boarded: (gemiye, uçağa vb.) binmiş, tahta kaplanmış
boasting: övünme, böbürlenme
bode: işaret olmak, (-e) delalet etmek
bolstered: desteklenmiş, güçlendirilmiş
bolster: desteklemek, güçlendirmek, destek
bombarded: bombalanmış, bombardımana tutulmuş, (soru vb.) yağmuruna tutulmuş
bondage: esaret, kölelik, boyunduruk
boom: patlama (ekonomik vb.), hızlı artış, gümbürtü
boosts: artırır, destekler, yükseltir
borderline: sınırda, belirsiz, sınır çizgisi
bother: rahatsız etmek, zahmet vermek, sıkıntı, dert
botany: botanik, bitki bilimi
bouts: nöbet, kriz, karşılaşma (boks vb.), dönem
bragging: övünme, böbürlenme
branch: dal, şube, kol
breakthrough: atılım, çığır açan gelişme, büyük buluş
breed: yetiştirmek (hayvan), üremek, neden olmak, cins, soy
brewing: demlenen, gelişmekte olan, hazırlanmakta olan (genellikle olumsuz)
brink: kenar, eşik (-ın eşiğinde)
broached: (konuyu) açmak, ortaya atmak, değinmek
brutal: acımasız, vahşi, zalim
bubble: kabarcık, baloncuk, geçici parlak dönem (ekonomik vb.)
bullying: zorbalık, kabadayılık
buoys: şamandıralar, desteklemek, moral vermek
burden: yük, külfet, sorumluluk
burdensome: külfetli, ağır, zahmetli
bureaucrat: bürokrat
bureaucracy: bürokrasi
burying: gömme, defnetme
by-product: yan ürün
calamitous: feci, felaket getiren, yıkıcı
calamity: felaket, afet, musibet
calculating: hesaplayan, çıkarcı, hesapçı (mecazi)
calibration: kalibrasyon, ayarlama
caliphate: halifelik
camouflage: kamuflaj, gizleme
campaign: kampanya, sefer
capabilities: yetenekler, kabiliyetler, kapasiteler
capacity: kapasite, sığa, yetenek
capitalist: kapitalist, sermayedar
capitulated: teslim olmuş, boyun eğmiş
capsules: kapsüller
captivating: büyüleyici, çekici, cezbedici
captive: esir, tutsak
captivity: esaret, tutsaklık
captured: yakalanmış, ele geçirilmiş, esir alınmış
cardiovascular: kardiyovasküler, kalp ve damar sistemiyle ilgili
cardiorespiratory: kardiyorespiratuvar, kalp ve solunum sistemiyle ilgili
carnivores: etoburlar, etçiller
cartilage: kıkırdak
cataclysms: büyük felaketler, köklü değişimler, kataklizmler
catalogued: kataloglanmış, sınıflandırılmış
catalogue: katalog, kataloglamak
catastrophes: felaketler, facialar, katastroflar
catastrophic: feci, felaket getiren, yıkıcı
catastrophically: feci bir şekilde, felaketle sonuçlanarak
categorised: kategorize edilmiş, sınıflandırılmış
cater: yiyecek içecek sağlamak, hitap etmek (-e), ihtiyacını karşılamak
caution: dikkat, ihtiyat, tedbir, uyarı
cautious: dikkatli, tedbirli, ihtiyatlı
cautiously: dikkatlice, tedbirli bir şekilde
caveats: uyarılar, ikazlar, çekinceler
celestial: göksel, semavi
censorship: sansür
centralisation: merkezileştirme, merkezileşme
centralised: merkezileştirilmiş, merkezi
ceremonial: törensel, merasimle ilgili
certainty: kesinlik, katiyet
cessation: durma, sona erme, kesilme
challenging: zorlu, meydan okuyan, iddialı
chaos: kaos, kargaşa, keşmekeş
chaperone: refakatçi, refakat etmek
characteristics: özellikler, nitelikler, karakteristikler
characterisations: karakterizasyonlar, tanımlamalar, betimlemeler
charities: hayır kurumları, yardım kuruluşları
charismatic: karizmatik, etkileyici
cherishing: değer verme, sevgiyle koruma, aziz tutma
chiselled: yontulmuş, keskin hatlı (yüz vb.)
choreographed: koreografisi yapılmış
chores: günlük ev işleri, angarya
chronic: kronik, müzmin
chroniclers: vakayinameler, tarih yazıcıları
chronotype: kronotip
chunkier: daha iri parçalı, daha tıknaz, daha kalın
circadian: sirkadiyen, günlük (ritim)
circulating: dolaşan, dolaşımda olan
circumnavigating: etrafını dolaşan (deniz yoluyla vb.)
circumstances: koşullar, şartlar, durumlar
cited: alıntılanan, atıfta bulunulan, bahsedilen
citizenry: vatandaşlar (topluluk olarak), halk
clans: klanlar, aşiretler, boylar
clarification: açıklama, açıklığa kavuşturma
clarity: açıklık, netlik, berraklık
clash: çatışma, çarpışma, uyuşmazlık, çatışmak
classification: sınıflandırma, tasnif
classify: sınıflandırmak, tasnif etmek
clergy: ruhban sınıfı, din adamları
clichés: klişeler, basmakalıp sözler
clinging: yapışan, sarılan, tutunan
clinicians: klinisyenler, klinik hekimleri
cloning: klonlama, kopyalama
clotting: pıhtılaşma
clumps: kümeler, yığınlar, topaklar
clumsy: sakar, beceriksiz, hantal
cluster: küme, grup, kümelenmek
clustering: kümelenme, gruplanma
co-occur: birlikte meydana gelmek, eş zamanlı olmak
coalesce: birleşmek, kaynaşmak
coastal: kıyısal, sahil
cognition: biliş, idrak, kavrama
cognitive: bilişsel, idraksal
cognitively: bilişsel olarak
coherent: tutarlı, uyumlu, mantıklı
coherence: tutarlılık, uyum, bütünlük
cohesion: bağlılık, yapışma, bütünlük (grup vb.), uyum
cohesiveness: bağlılık, bütünlük, kenetlenmişlik
coincidentally: tesadüfen, rastlantısal olarak
coined: (kelime, ifade) uydurulmuş, icat edilmiş
collaboration: işbirliği, ortak çalışma
collaborative: işbirlikçi, ortak, kolektif
collapse: çökmek, yıkılmak, çöküş, yıkılma
collateral: teminat, güvence, yan, ikincil
colleagues: meslektaşlar, iş arkadaşları
collections: koleksiyonlar, derlemeler
collective: kolektif, ortak, toplu
collectively: toplu olarak, hep birlikte, müştereken
collectors: koleksiyoncular, toplayıcılar
collide: çarpışmak, tokuşmak
colliding: çarpışan, tokuşan
collision: çarpışma, tokuşma
colloquially: konuşma dilinde, halk ağzıyla
colonial: sömürgeci, kolonyal
colonisation: sömürgeleştirme, kolonizasyon
colonised: sömürgeleştirilmiş, kolonize edilmiş
colossal: devasa, kocaman, muazzam
combat: savaşmak, mücadele etmek, savaş, mücadele
combination: kombinasyon, birleşim
commemorate: anmak, anısını yaşatmak
commemorative: anma amaçlı, hatıra
commenced: başladı, başlatıldı
commendable: övgüye değer, takdire şayan
commercialisation: ticarileştirme, ticarileşme
commission: komisyon, heyet, görevlendirme, komisyon (ücret)
commitment: bağlılık, taahhüt, adanmışlık
commodity: ticari mal, emtia
commoner: avamdan kimse, sıradan vatandaş (tarihsel)
communal: toplumsal, ortak, kamuya ait
communicative: iletişimsel, konuşkan
community-based: toplum temelli, topluluğa dayalı
commute: işe gidip gelmek
compact: kompakt, sıkı, yoğun, küçük, sözleşme
comparatively: nispeten, oranla, kıyasla
comparison: karşılaştırma, kıyaslama
compassion: şefkat, merhamet
compensate: telafi etmek, karşılamak, bedelini ödemek
compensatory: telafi edici, karşılayıcı
competence: yeterlilik, ehliyet, ustalık
competent: yeterli, ehil, yetenekli
competitively: rekabetçi bir şekilde
competitiveness: rekabet gücü, rekabetçilik
complacency: kayıtsızlık, rehavet, kendi halinden memnunluk (genellikle olumsuz)
complaint: şikayet, yakınma, rahatsızlık (tıbbi)
complementary: tamamlayıcı, bütünleyici
complexity: karmaşıklık, komplekslik
compliance: uyum, riayet, uygunluk (kurallara vb.)
complicating: karmaşıklaştıran, zorlaştıran
complicated: karmaşık, komplike, karışık
compliments: iltifatlar, övgüler
components: bileşenler, unsurlar, parçalar
compose: oluşturmak, bestelemek, yazmak
composed: -den oluşan, sakin, soğukkanlı
composite: kompozit, bileşik, karma
composition: kompozisyon, beste, yapı, bileşim
compound: bileşik, bileşim, birleştirmek, ağırlaştırmak
compounded: birleştirilmiş, katmerlenmiş, ağırlaştırılmış
comprehension: anlama, kavrama, idrak
comprehensive: kapsamlı, etraflı, geniş
compress: sıkıştırmak, kompres (noun)
comprised: -den oluşan, kapsayan, içeren
compromises: tavizler, uzlaşmalar (noun), taviz vermek, uzlaşmak, tehlikeye atmak (verb)
compulsion: zorunluluk, zorlama, içsel dürtü
compulsorily: zorunlu olarak, mecburen
compulsory: zorunlu, mecburi
computation: hesaplama, hesap
computational: hesaplamalı, bilişimsel
compute: hesaplamak
conceal: gizlemek, saklamak
concealed: gizlenmiş, saklanmış
concealment: gizleme, saklama
conceivably: muhtemelen, akla uygun olarak, düşünülebilir ki
conceive: tasarlamak, düşünmek, akıl erdirmek, gebe kalmak
conceived: tasarlanmış, düşünülmüş
concentration: konsantrasyon, yoğunlaşma, derişim (kimya)
concept: kavram, konsept
conception: kavrayış, anlayış, düşünce, fikir, gebe kalma
conceptual: kavramsal
conceptualise: kavramsallaştırmak
concern: ilgi, endişe, kaygı, ilgilendirmek (verb)
concerned: endişeli, ilgili, kaygılı
concerted: ortaklaşa, uyumlu, planlı
conclusive: kesin, kati, sonuca götüren
conclusively: kesin olarak, kati surette
condemned: kınanmış, mahkum edilmiş
condensing: yoğunlaştıran, yoğunlaşan, sıkıştıran
confer: görüşmek, danışmak, vermek, bahşetmek
confess: itiraf etmek, günah çıkarmak
confidential: gizli, mahrem
configuration: yapılandırma, konfigürasyon, düzenleme
confine: sınırlamak, hapsetmek, tutmak
confirm: onaylamak, doğrulamak, teyit etmek
confirming: onaylayan, doğrulayan
confirmation: onaylama, doğrulama, teyit
confiscated: el konulmuş, müsadere edilmiş
conflict: çatışma, anlaşmazlık, uyuşmazlık
confluence: birleşme yeri (nehir vb.), izdiham, bir araya gelme
conform: uymak, uygun davranmak, benzemek (-e)
conformity: uyum, uygunluk, uyma (normlara, kurallara vb.)
confound: kafasını karıştırmak, şaşırtmak, çürütmek
confront: yüzleşmek, karşı karşıya gelmek/getirmek
confusing: kafa karıştırıcı, şaşırtıcı
congestion: tıkanıklık, sıkışıklık (trafik, burun vb.)
congregated: toplanmış, bir araya gelmiş
congruent: uyumlu, denk, ahenkli
coniferous: iğne yapraklı, kozalaklı
conjectural: tahmini, varsayımsal, kurgusal
connections: bağlantılar, ilişkiler
connotations: yan anlamlar, çağrışımlar
conquer: fethetmek, yenmek, üstesinden gelmek
conquered: fethedilmiş, yenilmiş
conquest: fetih, zaptetme
conscientious: vicdanlı, titiz, özenli
conscientiously: vicdanlı bir şekilde, titizlikle
conscientiousness: vicdanlılık, titizlik, özenlilik
consciousness: bilinç, şuur
consecrated: kutsanmış, adanmış
consecutively: art arda, peş peşe
consensus: fikir birliği, uzlaşma, konsensüs
consequence: sonuç, netice, önem
conservation: koruma, muhafaza (doğa, tarihi eser vb.)
conservationists: çevreciler, korumacılar
conservative: muhafazakar, tutucu
considerably: önemli ölçüde, oldukça, epeyce
consistency: tutarlılık, kıvam, uyum
consistent: tutarlı, istikrarlı, uyumlu
consistently: tutarlı bir şekilde, sürekli olarak, istikrarlı biçimde
consolidation: birleştirme, sağlamlaştırma, konsolidasyon
consolidate: birleştirmek, sağlamlaştırmak, pekiştirmek
conspicuous: göze çarpan, dikkat çekici, bariz
conspiracy: komplo, suikast planı
constant: sabit, sürekli, değişmez
constituents: bileşenler, unsurlar, seçmenler
constitute: oluşturmak, teşkil etmek, kurmak
constrains: kısıtlar, sınırlar, zorlar
construction: inşaat, yapı, yapım
consumer: tüketici
consumption: tüketim
contagious: bulaşıcı
contaminants: kirleticiler, bulaşıcı maddeler
contamination: kirlenme, bulaşma, kontaminasyon
contaminated: kirlenmiş, bulaşmış, kontamine olmuş
contemplation: derin düşünme, tefekkür, temaşa
contemporaneously: eş zamanlı olarak, çağdaş olarak
contemporary: çağdaş, modern, aynı döneme ait
contempt: aşağılama, küçümseme, hor görme
contend: iddia etmek, çekişmek, mücadele etmek
content: içerik, muhteva, memnun, hoşnut (adj)
contentious: tartışmalı, çekişmeli, kavgacı
contentment: memnuniyet, hoşnutluk, tatmin
context: bağlam, ortam, çevre
contiguous: bitişik, komşu
contingency: olasılık, ihtimal, beklenmedik durum
continual: sürekli, devamlı (genellikle aralıklı)
continuum: süreklilik, devamlılık gösteren dizi, spektrum
contour: çevre çizgisi, kontur, dış hat
contraction: kasılma, büzülme, kısaltma (dilbilgisi)
contradict: çelişmek, tersini söylemek, yalanlamak
contradiction: çelişki, tutarsızlık
contradictory: çelişkili, tutarsız
contrary: aksi, ters, zıt, aksine (adv)
contrast: zıtlık, karşıtlık, kontrast, karşılaştırmak (verb)
contravene: ihlal etmek, aykırı davranmak, karşı gelmek
contribute: katkıda bulunmak, katkı sağlamak, sebep olmak
controversial: tartışmalı, ihtilaflı
controversy: tartışma, anlaşmazlık, ihtilaf
conveniently: uygun bir şekilde, elverişli olarak
conventional: geleneksel, alışılagelmiş, konvansiyonel
conventionally: geleneksel olarak, alışılageldiği şekilde
conventions: gelenekler, kurallar, teamüller, toplantılar, kongreler
converge: yakınsamak, bir noktada birleşmek, aynı yöne yönelmek
convergent: yakınsak, birleşen
conversely: aksine, tersine olarak
conversion: dönüşüm, dönüştürme, din değiştirme
convert: dönüştürmek, çevirmek, dinini değiştirmek (verb)
convertibly: dönüştürülebilir şekilde
convey: iletmek, aktarmak, taşımak
conveyed: iletilmiş, aktarılmış, taşınmış
convicted: mahkum edilmiş, hüküm giymiş
conviction: mahkumiyet, hüküm, güçlü inanç, kanı
convincingly: ikna edici bir şekilde
conviviality: şen şakraklık, neşe, keyifli sosyallik
convoluted: karmaşık, dolambaçlı, anlaşılması zor
cooperate: işbirliği yapmak, yardımlaşmak
cooperation: işbirliği, yardımlaşma
coordination: koordinasyon, eşgüdüm, uyum
cope: başa çıkmak, üstesinden gelmek (-ile)
copious: bol, çok miktarda, bereketli
copying: kopyalama, kopya çekme
copyrights: telif hakları
correlate: ilişkili olmak, korelasyon göstermek, ilişkilendirmek (verb)
correlation: korelasyon, ilişki, bağıntı
correspond: karşılık gelmek, tekabül etmek, yazışmak
corresponds: karşılık gelir, tekabül eder, yazışır
corridor: koridor, geçit
corrosion: korozyon, aşınma, paslanma
corrupt: yozlaşmış, bozuk, rüşvetçi, bozmak, yozlaştırmak (verb)
corruption: yolsuzluk, yozlaşma, bozulma
cosmic: kozmik, evrensel
cosmologist: kozmolog, evren bilimci
counterpart: mevkidaş, karşılık, benzer
counters: sayaçlar, tezgahlar (noun), karşı koyar, karşılık verir (verb)
countervailing: dengeleyici, karşı etkili
counterproductive: ters etki yapan, amaca zarar veren, verimsiz
courage: cesaret, yüreklilik
courteous: nazik, kibar, saygılı
courtesy: nezaket, kibarlık, incelik
coverage: kapsama alanı, yayın alanı, haberleştirme, teminat (sigorta)
coveted: imrenilen, çok istenen, gıpta edilen
covert: gizli, örtülü, saklı
crackdown: sıkı önlem, baskı operasyonu
cradle: beşik, köken, başlangıç yeri
craft: zanaat, el sanatı, ustalık, gemi, tekne, uçak
crags: sarp kayalıklar
cramped: sıkışık, dar, basık
cranium: kafatası
crawl: emeklemek, sürünmek
credential: kimlik bilgisi, yeterlilik belgesi, referans
credibility: güvenilirlik, inanılırlık, itibar
credible: güvenilir, inanılır
credited: -e atfedilen, -nın hesabına kaydedilen, itibar edilen
creeping: sürünen, sinsice ilerleyen, yavaş yavaş yayılan
criteria: kriterler, ölçütler (criterion'un çoğulu)
criticism: eleştiri, tenkit
critics: eleştirmenler, muhalifler
critiques: eleştiriler (genellikle detaylı, akademik), kritik yazıları
crucial: çok önemli, kritik, hayati
crucially: kritik bir şekilde, hayati olarak
crude: ham, işlenmemiş, kaba, basit
crystalline: kristal, kristalimsi, billur gibi
cues: ipuçları, işaretler, replikler (tiyatro)
cuisine: mutfak (bir ülkenin, bölgenin yemek kültürü)
culminated: zirveye ulaşmış, sonuçlanmış (-ile)
culprit: suçlu, sanık, sorumlu
cultivate: yetiştirmek (bitki, ürün), işlemek (toprak), geliştirmek (beceri, ilişki)
cultivating: yetiştirme, geliştirme
cultivation: yetiştirme, tarım, işleme, geliştirme
cultural: kültürel
cumulative: kümülatif, birikimli, toplam
curbing: frenleme, dizginleme, kontrol altına alma
curiosity: merak
curiously: merakla, tuhaf bir şekilde
currency: para birimi, geçerlilik, yaygınlık
custodial: velayetle ilgili, gözetimle ilgili, gözaltı
cyclical: döngüsel, devirli
cylinders: silindirler
cynical: sinik, alaycı, kötümser, çıkarcı
dampen: nemlendirmek, azaltmak, hafifletmek, köreltmek (heves vb.)
dampening: nemlendirme, azaltma, hafifletme
darts: dart oyunu, oklar, ani fırlamalar, hızlı hareketler (noun), fırlatır (verb)
database: veritabanı
daunting: göz korkutucu, yıldırıcı, ürkütücü
dazzling: göz kamaştırıcı, büyüleyici
debuted: ilk kez sahneye çıktı, ilk kez piyasaya sürüldü
decade: on yıl, dekad
decay: çürüme, bozulma, zayıflama, çürümek, bozulmak (verb)
deceit: hile, aldatma, dalavere
deceived: aldatılmış, kandırılmış
deceiver: aldatan, hilekar kişi
decentralised: merkezi olmayan, ademi merkeziyetçi
decelerated: yavaşlamış, hızı azaltılmış
decency: terbiye, edep, uygunluk, nezaket, saygınlık
deceptive: aldatıcı, yanıltıcı
decipher: deşifre etmek, (şifreyi/yazıyı) çözmek, anlamını çözmek
decisive: kararlı, kesin, kati, belirleyici
declarations: beyanlar, bildiriler, ilanlar
decline: düşüş, gerileme, azalma, reddetmek, gerilemek (verb)
decode: kodunu çözmek, deşifre etmek
decomposition: ayrışma, çürüme, bozulma
dedicate: adamak, ithaf etmek, vakfetmek
dedicated: adanmış, kendini işine vermiş, özel (amaç için ayrılmış)
dedication: adanmışlık, özveri, ithaf
deduct: çıkarmak, düşmek (hesaptan vb.), kesinti yapmak
deems: kabul eder, sayar, addeder, öyle görür
defamatory: iftira niteliğinde, karalayıcı, küçük düşürücü
defeat: yenilgi, yenmek, mağlup etmek (verb)
defect: kusur, hata, arıza, taraf değiştirme, iltica etme (verb)
defective: kusurlu, bozuk, arızalı, hatalı
defend: savunmak, korumak
defer: ertelemek, saygı göstermek, boyun eğmek (-e)
deficient: eksik, yetersiz (-de)
definitive: kesin, nihai, kati, belirleyici
definitively: kesin olarak, kati surette, nihai olarak
deflect: saptırmak, yönünü değiştirmek, savuşturmak, bertaraf etmek
deflected: saptırılmış, yönü değiştirilmiş, savuşturulmuş
defoliate: yapraklarını dökmek/döktürmek
deforestation: ormansızlaşma, ormanların yok edilmesi
defy: meydan okumak, karşı gelmek, hiçe saymak
degrade: aşağılamak, küçük düşürmek, kalitesini düşürmek, boz(ul)mak
dehydrated: susuz kalmış, suyu çekilmiş, dehidre
deity: tanrı, tanrıça, ilah
deliberately: kasten, kasıtlı olarak, bilerek, dikkatlice, özenle
deliberation: dikkatli düşünme, tartma, müzakere, kasıtlılık
delicacy: incelik, hassasiyet, lezzetli yiyecek, nezaket
delicate: narin, hassas, ince, kırılgan, diplomatik ustalık gerektiren
delight: büyük zevk, keyif, haz, memnun etmek, sevindirmek (verb)
delinquency: suçluluk (genellikle gençlerde), kabahat, ihmal
delirium: hezeyan, sayıklama, bilinç bulanıklığı
delivery: teslimat, dağıtım, doğum, sunum, konuşma tarzı
delusion: sanrı, yanılgı, kuruntu, aldanma
delusions: sanrılar, yanılgılar, kuruntular
demarcation: sınır çizme, ayırma, belirleme, sınır çizgisi
dementia: bunama, demans
demise: ölüm, vefat, sona erme, çöküş
demographic: demografik, nüfusla ilgili (adj), demografik grup (noun)
demolish: yıkmak, tahrip etmek, yerle bir etmek
demonstrate: göstermek, kanıtlamak, sergilemek, gösteri yapmak
demonstrating: gösteren, kanıtlayan, gösteri yapan
demotion: rütbe indirme, tenzil-i rütbe
denial: inkar, red, yadsıma
deniably: inkar edilebilir bir şekilde
denote: göstermek, belirtmek, ifade etmek, anlamına gelmek
density: yoğunluk
department: bölüm, departman, daire (bakanlık vb.)
dependency: bağımlılık, bağlılık, muhtaçlık
depict: tasvir etmek, betimlemek, resmetmek, anlatmak
depicted: tasvir edilmiş, betimlenmiş, anlatılmış
depiction: tasvir, betimleme, anlatım
depictions: tasvirler, betimlemeler
deplete: tüketmek, azaltmak, bitirmek (kaynakları vb.)
deploy: konuşlandırmak, görevlendirmek, yerleştirmek (askeri, kaynak vb.)
deposited: yatırılmış (para), biriktirilmiş, çökelmiş, emanet edilmiş
deprave: ahlakını bozmak, yoldan çıkarmak, baştan çıkarmak
depreciating: değer kaybeden, küçümseyen, hafife alan
depressing: iç karartıcı, moral bozucu, üzücü
depression: depresyon, bunalım, ekonomik durgunluk, çöküntü (coğrafi)
deprivation: yoksunluk, mahrumiyet
deprived: yoksun, mahrum (bırakılmış)
deprive: yoksun bırakmak, mahrum etmek (-den)
derivation: türetme, türev, köken, kaynak
derivative: türev, türetilmiş (ürün, kelime vb.), özgün olmayan, taklitçi (adj)
derive: türetmek, elde etmek, çıkarmak, kaynaklanmak (-den)
derived: türetilmiş, elde edilmiş, kaynaklanan
descendants: torunlar, soyundan gelenler, ahfat
deserve: hak etmek, layık olmak (-i)
designation: atanma, görevlendirme, adlandırma, isim verme, unvan
desirable: arzu edilir, istenir, cazip, makbul
desires: arzular, istekler, tutkular
despair: umutsuzluk, çaresizlik, yeis, umudunu kesmek (verb)
despise: hor görmek, küçümsemek, tiksinmek (-den)
despotic: despotik, zalim, baskıcı
destabilise: istikrarsızlaştırmak, dengesini bozmak
destiny: kader, alın yazısı, yazgı
destructive: yıkıcı, tahrip edici, zararlı
destructiveness: yıkıcılık, tahripkarlık
detach: ayırmak, sökmek, koparmak, görevlendirmek (askeri)
detached: ayrı, ayrık, tarafsız, nesnel, ilgisiz, mesafeli
detachment: ayırma, ayrılma, tarafsızlık, nesnellik, müfreze (askeri)
detect: tespit etmek, bulmak, saptamak, algılamak, fark etmek
detection: tespit etme, bulma, saptama, algılama
deteriorate: kötüleşmek, bozulmak, fenalaşmak, durumu ağırlaşmak
deterioration: kötüleşme, bozulma, fenalaşma, gerileme
determinant: belirleyici faktör, etken, determinant (matematik)
determination: kararlılık, azim, belirleme, saptama
determine: belirlemek, saptamak, kararlaştırmak, karar vermek
determined: kararlı, azimli
deterrence: caydırıcılık
deterrent: caydırıcı (şey/faktör/sebep)
deters: caydırır, vazgeçirir, engeller
detest: nefret etmek, tiksinmek, iğrenmek (-den)
detestable: iğrenç, nefret edilesi, menfur
detoxify: detoksifiye etmek, zehirden arındırmak
detrimental: zararlı, zarar verici, muzır (-e)
devastating: yıkıcı, mahvedici, harap edici, çok sarsıcı (haber vb.)
devastation: yıkım, tahribat, harabiyet, büyük hasar
deviation: sapma, ayrılma, farklılık, inhiraf
devise: tasarlamak, icat etmek, düşünmek, bulmak (plan, yöntem vb.)
devised: tasarlanmış, düşünülmüş, icat edilmiş
devolution: yetki devri (merkezden yerele vb.)
devote: adamak, vakfetmek, ayırmak (zaman, çaba vb.)
devoted: sadık, bağlı, adanmış, fedakar
devotion: bağlılık, sadakat, adanmışlık, düşkünlük, dindarlık
devouring: yalayıp yutan, oburca yiyen, hızla tüketen, kemiren (endişe vb.)
dexterity: el becerisi, maharet, ustalık, çeviklik
diagnosis: teşhis, tanı
diagnosed: teşhis edilmiş, tanısı konmuş
diagnostically: teşhis amacıyla, tanısal olarak
dialect: lehçe, diyalekt, ağız
diametrically: taban tabana, tamamen zıt, bütünüyle karşıt
dictatorships: diktatörlükler
dictates: emirler, buyruklar (noun), dikte etmek, emretmek, zorunlu kılmak (verb)
differ: farklı olmak, ayrılmak, aynı fikirde olmamak (-den)
differentiate: ayırt etmek, farklılaştırmak, farkı görmek
differentiation: farklılaşma, farklılaştırma, ayırt etme
diffusion: yayılma, dağılma, difüzyon (fizik, kimya), yaygınlaşma (fikir vb.)
digest: sindirmek (yiyecek), hazmetmek, anlamak (bilgi), özet, derleme (noun)
digestible: sindirilebilir, hazmedilebilir, anlaşılması kolay
digestion: sindirim, hazım
digitisation: dijitalleştirme, sayısallaştırma
dignity: itibar, saygınlık, haysiyet, onur, vakar
diligence: çalışkanlık, gayret, özen, dikkat
diligently: özenle, gayretle, dikkatle, çalışkanlıkla
dilute: seyreltmek, sulandırmak, hafifletmek, etkisini azaltmak
dimension: boyut, ebat, yön
diminish: azaltmak, eksiltmek, azalmak, eksilmek, küçümsemek
diminished: azalmış, eksilmiş, küçülmüş
diminutive: küçük, minik, ufak tefek, küçültme eki
diplomacy: diplomasi, dış ilişkiler, ustalık, incelik (davranışta)
directness: dolaysızlık, açıklık, netlik, dobra olma
disability: engellilik, sakatlık, acziyet, yetersizlik
disadvantage: dezavantaj, mahzur, sakınca, olumsuz durum
disapprove: onaylamamak, tasvip etmemek, karşı çıkmak (-i)
disarray: düzensizlik, kargaşa, karışıklık, dağınıklık
disaster: felaket, facia, afet, yıkım
disastrous: feci, korkunç, felaket getiren, yıkıcı
disbelief: inançsızlık, inanmama, güvensizlik
discern: fark etmek, ayırt etmek, sezmek, seçmek, algılamak
discernible: fark edilebilir, görülebilir, seçilebilir, ayırt edilebilir
discerning: anlayışlı, zeki, ferasetli, ayırt etme yeteneği olan
discharge: taburcu etmek, boşaltmak, akıtmak, ateş etmek, görevden atmak, yerine getirmek (görev), tahliye, deşarj, akıntı (noun)
discipline: disiplin, düzen, bilim dalı, uzmanlık alanı, eğitmek, cezalandırmak (verb)
disclosed: açıklanmış, ifşa edilmiş, ortaya çıkarılmış
discomfort: rahatsızlık, huzursuzluk, sıkıntı, ağrı
discord: anlaşmazlık, uyuşmazlık, ahenksizlik, nifak
discount: indirim, iskonto, göz ardı etmek, önemsememek, hesaba katmamak (verb)
discourse: söylem, konuşma, nutuk, tartışma, inceleme (yazılı/sözlü)
discredit: gözden düşürmek, itibarını sarsmak, güvenilirliğini azaltmak, itibarsızlık, şüphe (noun)
discredited: gözden düşmüş, itibarsızlaşmış, güvenilirliği kalmamış
discreetly: gizlice, ihtiyatlı bir şekilde, ustaca, kimseyi rahatsız etmeden
discrepancies: tutarsızlıklar, farklılıklar, uyuşmazlıklar, çelişkiler
discrete: ayrı, farklı, belirgin, kesikli (matematik)
discriminate: ayrımcılık yapmak (-e karşı), ayırt etmek, farkını görmek (-i, -den)
discrimination: ayrımcılık, ayırt etme, fark gözetme
disdain: küçümseme, hor görme, tenezzül etmeme, küçümsemek (verb)
disentangle: çözmek (düğüm, karışıklık), ayırmak, içinden çıkmak
disentangled: çözülmüş, ayrılmış, karışıklıktan kurtulmuş
disgrace: rezalet, utanç, yüz karası, gözden düşme, rezil etmek, utandırmak (verb)
disgruntled: hoşnutsuz, huysuz, küskün, sızlanan
disguise: kılık değiştirmek, gizlemek, maskelemek, kılık değiştirme, maske, gizleme (noun)
disillusioned: hayal kırıklığına uğramış, gözü açılmış, umudu kırılmış
disintegrate: parçalanmak, dağılmak, çözülmek, bütünlüğünü kaybetmek
dismantling: sökme, parçalarına ayırma, dağıtma, lağvetme
dismay: dehşet, korku, endişe, hayal kırıklığı, dehşete düşürmek, endişelendirmek (verb)
dismiss: kovmak, reddetmek, dikkate almamak, dağıtmak
disobedience: itaatsizlik
disorders: bozukluklar, rahatsızlıklar, düzensizlikler
disorientation: yönelim bozukluğu, şaşkınlık, oryantasyon kaybı
disparity: eşitsizlik, farklılık, uyumsuzluk
dispassionate: tarafsız, duygulara kapılmayan, soğukkanlı
dispatch: göndermek, yollamak, sevk etmek, halletmek, öldürmek (nadir)
dispel: gidermek (şüphe, korku vb.), dağıtmak, yok etmek
dispensable: vazgeçilebilir, gereksiz, olmasa da olur
dispense: dağıtmak, vermek, (ilaç) hazırlayıp vermek, uygulamamak (kural vb.)
dispersed: dağılmış, yayılmış, saçılmış
displace: yerinden etmek, yerini almak, sürmek
display: sergilemek, göstermek, ekran, gösterge (noun)
disposable: tek kullanımlık, atılabilir, elden çıkarılabilir (gelir vb.)
disposal: elden çıkarma, atma, imha, tasarruf, emir (kullanımına sunma)
disposition: mizaç, yaradılış, eğilim, düzenleme, yerleştirme
dispossessed: mülksüzleştirilmiş, elinden alınmış
disproportionate: orantısız, nispetsiz
disproportionately: orantısız bir şekilde
disproven: çürütülmüş, aksini ispatlanmış
dispute: anlaşmazlık, tartışma, ihtilaf (noun), tartışmak, itiraz etmek (verb)
disputed: tartışmalı, ihtilaflı, çekişmeli
disregard: önemsememek, hiçe saymak, görmezden gelmek (verb), aldırmazlık (noun)
disrupt: aksatmak, sekteye uğratmak, bozmak
disruption: aksama, kesinti, bozulma
disruptive: aksatan, engelleyici, yıkıcı, düzen bozucu
dissatisfaction: memnuniyetsizlik, hoşnutsuzluk, tatminsizlik
dissatisfied: memnuniyetsiz, hoşnutsuz, tatminsiz
dissecting: kesip inceleyen, teşrih eden
disseminate: yaymak (bilgi, fikir vb.), dağıtmak
disseminated: yayılmış, dağıtılmış
dissenting: muhalif, karşı görüşte olan, ayrılan
dissidents: muhalifler, karşıtlar
dissipate: dağıtmak, yok etmek, dağılmak, yok olmak, boşa harcamak (enerji, para vb.)
dissociated: ayrılmış, ilişkisiz, kopuk
dissolve: çözmek, eritmek, feshetmek (parlamento vb.), çözünmek, erimek
distance: mesafe, uzaklık
distancing: mesafe koyma, uzaklaştırma
distasteful: tatsız, nahoş, itici
distinct: belirgin, farklı, ayrı
distinction: ayrım, fark, özellik, üstünlük, şeref
distinctive: ayırt edici, kendine özgü, farklı
distinctively: ayırt edici bir şekilde, belirgin olarak
distinguished: seçkin, ünlü, değerli, ayırt edilmiş
distorted: çarpıtılmış, bozulmuş, tahrif edilmiş
distortion: çarpıtma, bozulma, tahrifat
distraction: dikkat dağıtıcı şey, oyalama, eğlence
distress: sıkıntı, üzüntü, tehlike, zor durum
distribute: dağıtmak, paylaştırmak, yaymak
distribution: dağıtım, dağılım, yayılma
disturbance: rahatsızlık, kargaşa, karışıklık, bozukluk
disturbing: rahatsız edici, endişe verici
ditch: hendek, ark (noun), (arabayı) hendeğe sürmek, terk etmek, başından atmak (verb)
diverge: ayrılmak (yol, fikir vb.), farklılaşmak, sapmak
diverse: çeşitli, farklı, değişik
diversification: çeşitlendirme, farklılaştırma
diversify: çeşitlendirmek, farklılaştırmak
diversity: çeşitlilik, farklılık
diverting: saptıran, başka yöne çeviren, oyalayıcı, eğlenceli
divisions: bölümler, kısımlar, tümenler (askeri), bölünme, ayrılık
divisive: bölücü, ayrılık yaratan
divorce: boşanma (noun), boşanmak (verb)
docile: uysal, söz dinleyen, yumuşak başlı
doctrines: doktrinler, öğretiler, ilkeler
document: belge (noun), belgelemek (verb)
domain: alan, etki alanı, saha, mülk
dominance: egemenlik, hakimiyet, baskınlık
dominate: egemen olmak, hükmetmek, hakim olmak, baskın olmak
domination: egemenlik, hakimiyet, tahakküm
donors: bağışçılar, vericiler (kan, organ vb.)
dormitories: yatakhaneler, yurtlar
dosage: dozaj, doz miktarı
doting: çok seven, üzerine titreyen, düşkün
doubt: şüphe, kuşku (noun), şüphe etmek, kuşkulanmak (verb)
doubtful: şüpheli, kuşkulu, belirsiz
downright: düpedüz, kesinlikle, apaçık, dobra dobra (adj/adv)
downward: aşağıya doğru, alçalan
dozens: düzinelerce, çok sayıda
drafting: taslak hazırlama, çizim yapma, (askere) çağırma
dramatically: önemli ölçüde, çarpıcı biçimde, dramatik olarak
drawbacks: dezavantajlar, sakıncalar, mahzurlar
draw on: faydalanmak, kullanmak, yararlanmak (-den)
dread: dehşet, korku, endişe (noun), dehşete düşmek, korkmak, endişelenmek (verb)
drifting: sürüklenen, başıboş dolaşan
drizzly: çiseleyen (hava), çisenti yağmurlu
drowsy: uykulu, mahmur, sersemlemiş
dual: çift, ikili
dualism: ikicilik, düalizm
dubious: şüpheli, kuşkulu, güvenilmez
dumb: dilsiz, sessiz, aptal, salak (argo)
duplicate: kopya, suret, ikinci nüsha (noun), kopyalamak, aynısını yapmak (verb), aynı, eş (adj)
duplication: kopyalama, çoğaltma, tekrarlama
durability: dayanıklılık, sağlamlık
duration: süre, müddet
dwell: ikamet etmek, yaşamak, üzerinde durmak, kafa yormak (-in)
dynamics: dinamikler, işleyiş biçimi
dynasties: hanedanlar, sülaleler
eager: istekli, hevesli, can atan
earmarked: tahsis edilmiş, ayrılmış (-e)
earned: kazanılmış, hak edilmiş
earthen: toprak, topraktan yapılmış
eccentricity: eksantriklik, tuhaflık, gariplik
ecology: ekoloji, çevre bilimi
ecosystem: ekosistem, çevresel sistem
ecotourism: ekoturizm
ecstasy: coşku, vecd, kendinden geçme
ecstatic: coşkulu, kendinden geçmiş, mest olmuş
edible: yenilebilir, yenebilir
editing: düzenleme, kurgu, editörlük
editorial: başyazı, editoryal (noun), editoryal, başmakaleye ait (adj)
efficacy: etkililik, tesirlilik, fayda
efficiently: verimli bir şekilde, etkili olarak
effluents: atık sular, dışarı akan sıvılar
egocentric: benmerkezci, egoist
ego: ego, benlik
elaborate: ayrıntılı, detaylı, özenli (adj), ayrıntılandırmak, detaylandırmak (verb)
elaborately: özenle, ayrıntılı bir şekilde
elaboration: ayrıntılandırma, detaylandırma, özen gösterme
elapsed: geçen (süre), geçmiş
elasticity: esneklik, elastikiyet
elders: yaşlılar, büyükler, ihtiyarlar
electorate: seçmenler, seçmen kitlesi
electrodermal: elektrodermal (deri ile ilgili elektriksel)
elegance: zarafet, şıklık, incelik
elementary: temel, ilkel, basit, başlangıç seviyesi
elevated: yükseltilmiş, yüksek, yüce
elicited: ortaya çıkarılmış, elde edilmiş (bilgi, tepki vb.)
eligible: uygun, seçilebilir, hak sahibi
eliminate: elemek, ortadan kaldırmak, yok etmek
elimination: eleme, ortadan kaldırma, yok etme
elite: seçkinler, elit tabaka (noun), seçkin, elit (adj)
eloquently: etkili ve güzel konuşarak, belagatli bir şekilde
elusive: yakalanması zor, anlaşılması zor, ele geçmez, kaypak
emancipation: özgürleşme, serbest bırakma, azat etme
embalm: mumyalamak, tahnit etmek
embargo: ambargo, yasaklama
embarrassed: utanmış, mahcup
embedded: gömülü, yerleşik, içine yerleştirilmiş
embodiment: somut örnek, simge, tecessüm, cisimleşmiş hal
embody: somutlaştırmak, cisimleştirmek, temsil etmek, içermek
embolden: cesaretlendirmek, yüreklendirmek
emboldened: cesaretlendirilmiş, cesaretlenmiş
embrace: kucaklamak, sarılmak, benimsemek, kabul etmek, içermek
embraced: kucaklanmış, benimsenmiş, kabul edilmiş
embryo: embriyo, cenin (ilk dönem)
emergence: ortaya çıkma, belirme, zuhur
emerged: ortaya çıkmış, belirmiş
eminent: seçkin, ünlü, saygın
emissions: emisyonlar, salımlar, yayılmalar (gaz, ısı vb.)
emitted: yayılmış, salınmış, çıkarılmış (gaz, ışık, ses vb.)
empathy: empati, duygudaşlık
empirical: deneysel, görgül, tecrübeye dayalı
empower: yetkilendirmek, güçlendirmek, olanak sağlamak
emulate: özenmek, taklit etmek, örnek almak, gıpta etmek
enactment: yasalaştırma, yürürlüğe koyma, (oyun) canlandırma
enamel: mine (diş, kaplama), emaye
encapsulate: kapsüllemek, özetlemek, içine almak
encapsulated: kapsüllenmiş, özetlenmiş, içine alınmış
encompasses: kapsar, içerir, çevreler
encounter: karşılaşmak, rastlamak (verb), karşılaşma, rastlantı (noun)
encouraged: teşvik edilmiş, cesaretlendirilmiş
encroach: tecavüz etmek, ihlal etmek, sınırını aşmak (-e)
endangered: nesli tükenmekte olan, tehlikede olan
endeavour: çaba, gayret (noun), çabalamak, gayret etmek (verb)
endemic: endemik, belirli bir bölgeye özgü (hastalık, bitki vb.)
endorse: onaylamak, desteklemek, ciro etmek (çek vb.)
endorphins: endorfinler (vücudun doğal ağrı kesicisi)
endowed: bahşedilmiş, bağışlanmış, yetenekli kılınmış (-ile)
endurance: dayanıklılık, tahammül, sabır
endure: dayanmak, katlanmak, tahammül etmek, sürmek, devam etmek
enforce: zorla kabul ettirmek, uygulamak (yasa vb.), yürütmek
engagement: nişanlanma, angajman, katılım, dahil olma, çatışma, çarpışma
engendered: meydana getirilmiş, neden olunmuş, doğurulmuş
engraved: oyulmuş, kazınmış, hakkedilmiş
engrossed: dalmış, kendini kaptırmış (-e), meşgul
enhanced: geliştirilmiş, artırılmış, iyileştirilmiş
enigmatic: gizemli, esrarengiz, anlaşılmaz
enlightened: aydınlanmış, bilgili, aydın
enormous: kocaman, muazzam, devasa
enormously: muazzam derecede, son derece, çok
enquiries: soruşturmalar, araştırmalar, sorular (inquiries olarak da yazılır)
enrich: zenginleştirmek, değer katmak
enrol: kaydolmak, kaydetmek, yazılmak (enroll olarak da yazılır)
ensuing: ardından gelen, sonraki, müteakip
entailed: gerektiren, zorunlu kılan, beraberinde getiren
entangled: dolaşmış, karışmış, bulaşmış (-e)
enterprising: girişimci, girişken, becerikli
entertainment: eğlence
entheses: entezler (tendon veya bağların kemiğe yapıştığı yerler)
enthusiasm: coşku, heves, şevk
enthusiasts: meraklılar, tutkunlar, hevesliler
entice: cezbetmek, ayartmak, baştan çıkarmak
entitled: hak sahibi, yetkili, başlıklı, adlı
entity: varlık, mevcudiyet, kurum, kuruluş
entrepreneurial: girişimci, girişimcilikle ilgili
entryway: giriş yolu, antre, hol
enunciate: telaffuz etmek, açıkça söylemek, beyan etmek
envisage: öngörmek, tasavvur etmek, gözünün önüne getirmek
envisioned: öngörülen, tasavvur edilen, hayal edilen
envious: kıskanç, haset eden
enzyme: enzim
ephemeral: geçici, fani, kısa ömürlü
epic: destansı, epik
epidemics: salgın hastalıklar, epidemiler
epidemiological: epidemiyolojik, salgın hastalıklarla ilgili
epilepsy: epilepsi, sara
epiphany: aydınlanma anı, epifani
epistemology: epistemoloji, bilgi felsefesi
epitome: özet, timsal, mükemmel örnek
epitomised: timsali olmak, mükemmel örneğini oluşturmak (fiilin geçmiş/sıfat hali)
equate: bir tutmak, eşitlemek, denk saymak
equilibrium: denge, ekilibriyum
equipped: donanımlı, teçhizatlı
eradicate: kökünü kurutmak, yok etmek, ortadan kaldırmak
eradication: kökünü kurutma, yok etme, ortadan kaldırma
erode: aşındırmak, erozyona uğratmak, yıpratmak
eroded: aşınmış, erozyona uğramış
erosion: erozyon, aşınma, yıpranma
erratic: düzensiz, değişken, kararsız, dengesiz
erupted: patlak verdi, püskürdü, fışkırdı
escalate: tırmanmak, artmak, yükselmek, kızışmak
escalated: tırmanmış, artmış, yükselmiş, kızışmış
esoteric: ezoterik, gizemli, sadece belirli bir grubun anladığı
espionage: casusluk
essential: gerekli, elzem, esas, temel
esteem: saygı, itibar, değer verme
esteemed: saygın, değerli, itibarlı
estimates: tahminler, kestirimler
estimation: tahmin, kestirim, değerlendirme
eternal: ebedi, sonsuz, ölümsüz
eternity: ebediyet, sonsuzluk
ethereal: uçuk, ruhani, çok hafif ve narin, eterik
ethically: etik olarak, ahlaki açıdan
ethics: etik, ahlak felsefesi, ahlak kuralları
ethnic: etnik, ırksal
ethnicity: etnik köken, milliyet
ethnocentrism: etnosantrizm, ırk merkezcilik, kendi kültürünü üstün görme
ethology: etoloji, hayvan davranış bilimi
ethos: etos, bir grubun veya dönemin karakteristiği/değerleri
etiolation: sararma, benzinin solması (bitkilerde ışıksızlıktan)
etymology: etimoloji, kökenbilim
eulogy: övgü, methiye (genellikle cenazede)
evacuate: tahliye etmek, boşaltmak
evade: kaçınmak, sakınmak, (sorumluluktan vb) kaçmak, sıyrılmak
evaluate: değerlendirmek, değer biçmek
evangelical: evanjelik, İncil'e dayanan, müjdeci
evaporate: buharlaşmak, uçup gitmek, yok olmak
evaporation: buharlaşma
evasive: kaçamaklı, kaçınan, üstü kapalı (cevap vb.)
eventually: sonunda, nihayetinde, er ya da geç
evident: açık, belli, aşikar
evoke: çağrıştırmak, uyandırmak (duygu, anı vb.)
evolution: evrim, gelişim
evolve: evrimleşmek, gelişmek, dönüşmek
exacerbate: şiddetlendirmek, kötüleştirmek, alevlendirmek
exaggerated: abartılmış, abartılı
exaltation: yüceltme, büyük sevinç, coşkunluk
exasperation: çileden çıkma, sabrın taşması, büyük öfke/bezginlik
excavated: kazılmış, (arkeolojik) kazısı yapılmış
excavation: kazı, hafriyat, (arkeolojik) kazı
exceeded: aşılmış, geçilmiş (-i aştı)
excel: üstün olmak, sivrilmek, çok başarılı olmak (-de)
excelled: üstün oldu, sivrilildi, çok başarılı oldu
exception: istisna, ayrı tutma
exceptionally: istisnai olarak, olağanüstü derecede
excerpt: alıntı, parça
excessive: aşırı, ölçüsüz, haddinden fazla
exchanged: değiş tokuş edilmiş, takas edilmiş
exclude: hariç tutmak, dışlamak, dahil etmemek
exclusively: sadece, yalnızca, özel olarak
excreted: dışkılanan, ifraz edilen, salgılanan (vücuttan atılan)
executed: idam edilmiş, icra edilmiş, yerine getirilmiş
execution: idam, icra, yerine getirme, uygulama
executive: yönetici, idari, yürütme (ile ilgili)
exemplary: örnek alınacak, kusursuz, ibretlik
exempted: muaf tutulmuş, hariç tutulmuş (-den muaf)
exertion: çaba, gayret, efor (fiziksel veya zihinsel)
exhalation: nefes verme, soluk verme, buhar, duman
exhausted: tükenmiş, çok yorgun, bitkin
exhaustion: tükenme, aşırı yorgunluk, bitkinlik
exhibition: sergi, gösteri
exhilaration: büyük neşe, coşku, canlanma
exhort: teşvik etmek, öğütlemek, ısrarla tavsiye etmek
exile: sürgün
existed: var olmuş, mevcut olmuş
exotic: egzotik, yabancı, sıra dışı
expanse: geniş alan, açıklık, uzam
expansion: genişleme, yayılma, büyüme
expanses: geniş alanlar, açıklıklar
expedient: amaca uygun, pratik, yararlı (bazen ilkesizce)
expeditions: keşif gezileri, seferler
expel: kovmak, okuldan/ülkeden atmak, dışarı atmak
expelled: kovulmuş, atılmış
expenditure: harcama, masraf, gider
experimentation: deney yapma, deneme
explicit: açık, net, belirtik
exploitation: sömürü, istismar, faydalanma
exploited: sömürülmüş, istismar edilmiş
exploration: keşif, araştırma
explosion: patlama, infilak
exponentially: üssel olarak, katlanarak (artan)
exposure: maruz kalma/bırakma, teşhir, açığa çıkarma
exquisite: enfes, nadide, zarif, çok güzel/ince
extant: mevcut, hala var olan, günümüze ulaşmış
extended: uzatılmış, genişletilmiş, uzun süreli
extensive: kapsamlı, geniş, yaygın
extensively: kapsamlı bir şekilde, geniş ölçüde
extinction: neslin tükenmesi, yok olma, sönme
extracting: çıkarma, özünü çıkarma
extraction: çıkarma, çekme (diş vb.), köken, soy
extravagant: müsrif, savurgan, aşırı, abartılı
extraterrestrial: dünya dışı (varlık)
extremely: son derece, aşırı derecede, çok
extrinsic: dışsal, harici, dıştan gelen
fabric: kumaş, doku, yapı
facilitate: kolaylaştırmak, olanak sağlamak
facilitator: kolaylaştırıcı
fallacies: yanılgılar, safsatalar, yanlış düşünceler
fallible: yanılabilir, hata yapabilir
fatal: ölümcül, vahim, kaçınılmaz (kötü sonuçlu)
fatalism: kadercilik, fatalizm
fatalistic: kaderci, fatalist
fate: kader, alın yazısı, akıbet
favour: iyilik, lütuf, tercih, kayırma (İngiliz İng.), favori
favourable: uygun, olumlu, lehte
feasible: yapılabilir, mümkün, uygulanabilir
feats: başarılar, hünerler, kahramanlıklar
fermented: fermente edilmiş, mayalanmış
ferocious: vahşi, yırtıcı, azgın
fertile: verimli, bereketli, doğurgan
fertilisers: gübreler
fester: iltihaplanmak, azmak (yara), kötüleşmek (durum)
feudal: feodal, derebeylik ile ilgili
fictionalised: kurgulanmış, romanlaştırılmış
fidelity: sadakat, bağlılık, vefa, aslına uygunluk (ses/görüntü)
fierce: şiddetli, sert, azgın, hırçın
filament: filaman, ince tel, iplikçik
finite: sonlu, sınırlı
firearms: ateşli silahlar
firing: ateşleme, ateş etme, işten çıkarma
firmness: sertlik, katılık, kararlılık, sıkılık
fixated: sabitlenmiş, takıntılı (-e takmış)
fixtures: demirbaşlar, sabit eşyalar (tesisat vb.)
flame: alev, ateş
flanked: yanında yer alan, iki yanında ... bulunan (-nın yanında)
flared: genişleyen (paça vb.), parlayan (alev, öfke)
flash: flaş, ani parlama, şimşek, anlık görüntü/düşünce
flasks: laboratuvar şişesi, matara, cep şişesi
flattery: dalkavukluk, pohpohlama, yağcılık
flawed: kusurlu, hatalı, defolu
fleeting: geçici, kısa süreli, anlık
flexibility: esneklik
flourished: gelişti, serpildi, başarılı oldu, (elinde) salladı
flourishes: gelişir, serpilir, başarılı olur, süsleme, gösterişli hareket
fluctuated: dalgalandı, değişti, inip çıktı
fluctuation: dalgalanma, değişim, inip çıkma
fluid: sıvı, akışkan, değişken, akıcı
flurry: telaş, koşuşturma, ani ve kısa süreli (kar/rüzgar)
flux: sürekli değişim, akış, akı
foe: düşman, hasım
folklore: folklor, halk bilimi, halk kültürü
folklorists: folklorcular, halk bilimciler
fond: düşkün, seven (-e düşkün)
foodborne: gıda kaynaklı (hastalık vb.)
foolproof: hatasız, herkesin kullanabileceği, yanlış yapılması imkansız
footprints: ayak izleri
footwear: ayakkabılar, ayak giysileri
foragers: yiyecek arayanlar/toplayıcılar
foray: kısa süreli saldırı/baskın, (yeni bir alana) ilk giriş/deneme
forefront: en ön sıra, ön plan, merkez
forego: vazgeçmek, feragat etmek, (-den) önce gitmek
forensic: adli (tıp, bilim vb.)
foremost: en önemli, başta gelen, önde gelen
foreseeable: öngörülebilir, tahmin edilebilir
forestry: ormancılık
forfeit: kaybetmek (hak, mal vb.), feragat etmek, ceza olarak kaybedilen şey
forge: sahtesini yapmak (imza, para vb.), (metal) dövmek, (ilişki vb.) kurmak
formidable: ürkütücü, zorlu, heybetli, başa çıkılması güç
formulate: formüle etmek, dikkatlice oluşturmak/ifade etmek
fortifies: güçlendirir, takviye eder, sağlamlaştırır
fortuitous: tesadüfi, şans eseri, rastlantısal
foster: geliştirmek, teşvik etmek, büyütmek (evlatlık gibi)
fostering: geliştiren, teşvik eden, büyüten
foundations: temeller, esaslar, vakıflar
fragmented: parçalanmış, bölünmüş
fragments: parçalar, kırıntılar
fragrance: güzel koku, parfüm
fragile: kırılgan, narin, hassas
frankly: açıkçası, dürüstçe söylemek gerekirse
fraternal: kardeşçe, kardeşlik (ile ilgili)
fraud: dolandırıcılık, sahtekarlık, sahtekar
free-range: serbest dolaşan (hayvan), doğal ortamda yetişen
freezing: dondurucu, çok soğuk, donma
frequently: sık sık, sıklıkla
friction: sürtünme, anlaşmazlık, sürtüşme
frigid: çok soğuk, dondurucu, soğuk, duygusuz (kişi)
frustrating: sinir bozucu, hayal kırıklığı yaratan
frustration: hayal kırıklığı, hüsran, engellenme hissi
fuelled: yakıt almış, körüklenmiş, desteklenmiş
fulfilling: tatmin edici, doyurucu, yerine getiren
fulfilment: yerine getirme, tatmin, icra
fully-fledged: tam teşekküllü, tam gelişmiş, eksiksiz
functioning: işlev görme, çalışma, işleyen
fundamentally: temelde, esas olarak, kökten
fungi: mantarlar, funguslar
furnishings: mobilya, eşya, döşemeler
furrowed: kırışık, çatık (kaş), sürülmüş (toprak)
fuses: sigortalar (noun), birleşir, kaynaşır (verb)
futile: nafile, boşuna, beyhude
futility: beyhudelik, boşunalık, nafilelik
fuzzy: bulanık, belirsiz, tüylü, havlı
gauge: ölçmek, tahmin etmek, gösterge, ölçer
gaze: dik dik bakmak, gözünü dikmek, bakış
gears: dişliler, vitesler
gender-neutral: cinsiyet ayrımı gözetmeyen, cinsiyetsiz
genealogy: soy bilimi, şecere, soy ağacı
generalisation: genelleme
generate: üretmek, oluşturmak, meydana getirmek
generation: nesil, kuşak, üretme, oluşturma
generosity: cömertlik, eli açıklık
generous: cömert, eli açık, bol
genesis: oluşum, başlangıç, köken, yaratılış
genetic: genetik, kalıtsal
genetically: genetik olarak
genome: genom, kalıtım materyali
genres: türler, çeşitler (sanat, edebiyat vb.)
genuine: gerçek, hakiki, samimi
genuinely: gerçekten, hakikaten, samimiyetle
geographically: coğrafi olarak, coğrafi açıdan
geological: jeolojik
geologically: jeolojik olarak
geology: jeoloji, yer bilimi
geometric: geometrik
geothermal: jeotermal, yer ısıl
germs: mikroplar, bakteriler
gestational: gebelikle ilgili, gebelik dönemi
gesture: jest, mimik, işaret, hareket
ghastly: korkunç, dehşet verici, berbat
ghostly: hayalet gibi, ürkütücü
giant: dev, kocaman
gigantic: devasa, kocaman, muazzam
gladiator: gladyatör
glamourized: göz alıcı hale getirilmiş, çekici gösterilmiş
glance: göz atmak, kısa bir bakış atmak, kısa bakış
gleefully: neşeyle, keyifle, sevinçle
glimpses: anlık görüntüler, kısa bakışlar
globalisation: küreselleşme
globe: küre, dünya, yerküre
gloomy: kasvetli, karanlık, iç karartıcı
glorified: yüceltilmiş, övülmüş, olduğundan iyi gösterilmiş
gnawing: kemiren, kemirme, (mecazi) içini kemiren (endişe vb.)
gorgeous: muhteşem, harika, çok güzel
gospel: İncil, müjde, temel ilke
governance: yönetişim, idare
govern: yönetmek, idare etmek, hükmetmek
graceful: zarif, nazik, incelikli
gradual: kademeli, aşamalı, yavaş yavaş olan
gradually: kademeli olarak, yavaş yavaş, zamanla
grappled: boğuştu, mücadele etti, kavradı
grasp: kavramak, anlamak, kavrayış, anlama
gratification: tatmin, haz, memnuniyet
gratitude: minnettarlık, şükran
gravely: ciddiyetle, ağır bir şekilde
gravity: yerçekimi, ciddiyet, önem, ağırlık
grazing: otlama, otlatma
grievances: şikayetler, yakınmalar, dertler
grief: keder, üzüntü, yas
grind: öğütmek, ezmek, sıkı çalışma, angarya
grisly: tüyler ürpertici, korkunç, dehşet verici
grocery: bakkal, market, bakkaliye ürünleri
grotesque: grotesk, acayip, tuhaf, biçimsiz
groundbreaking: çığır açan, yenilikçi, devrim niteliğinde
grounded: ayakları yere basan, temelli, (uçak) uçuşu iptal edilmiş, topraklanmış
guarantee: garanti etmek, güvence vermek, garanti, güvence
guardian: veli, vasi, koruyucu
gubernatorial: valilikle ilgili, valiye ait
guidance: rehberlik, yol gösterme, kılavuzluk
guidelines: ilkeler, prensipler, kılavuz çizgiler, yönergeler
guts: bağırsaklar, cesaret, yürek (mecazi)
gymnastics: jimnastik
habitat: habitat, yaşam alanı, doğal ortam
hailed: selamlandı, övgüyle karşılandı, dolu yağdı
hallucinations: halüsinasyonlar, sanrılar
hamper: engellemek, aksatmak, köstek olmak
hampered: engellenmiş, aksatılmış
happenstance: tesadüf, rastlantı
harassment: taciz, rahatsız etme, bezdirme
hard-wired: doğuştan gelen, yapısal, programlanmış
hardiness: dayanıklılık, sağlamlık
harmonious: uyumlu, ahenkli
harness: kullanmak, faydalanmak, (at vb.) koşum takmak, koşum takımı
harvesting: hasat etme, ürün toplama
harsh: sert, katı, acımasız, haşin
hastily: aceleyle, telaşla
hatch: yumurtadan çıkmak, kuluçkadan çıkmak, (plan) kurmak, kapak (gemi, uçak vb.)
haunting: akıldan çıkmayan, unutulmayan, rahatsız edici (anlamda)
hazardously: tehlikeli bir şekilde
hazards: tehlikeler, riskler
haze: hafif sis, pus, bulanıklık
headaches: baş ağrıları
heartily: içtenlikle, canı gönülden, afiyetle
heavily-armed: ağır silahlı
heeded: kulak verilen, dikkate alınan
heed: kulak vermek, dikkat etmek, önemsemek, dikkat, özen
heightened: artırılmış, yükseltilmiş, şiddetlenmiş
henceforth: bundan böyle, bundan sonra
heralds: müjdeler, haber verir (verb), haberciler, müjdeciler (noun)
herbaceous: otsu, otsul
herbal: bitkisel, otlarla ilgili
herbalist: aktar, otacı
herbicides: herbisitler, ot öldürücüler
herbivores: otoburlar, otçullar
herd: sürü (hayvan)
hereditary: kalıtsal, ırsi, soyaçekimsel
heritage: miras (kültürel, tarihi)
hesitate: tereddüt etmek, duraksamak, çekinmek
hesitant: tereddütlü, çekingen, kararsız
heterogeneity: heterojenlik, çeşitlilik, türdeş olmama
hierarchical: hiyerarşik, aşamalı
hierarchy: hiyerarşi, aşama sırası
high-tech: yüksek teknoloji
high-yielding: yüksek verimli
highlights: vurgular, öne çıkarır (verb), önemli noktalar, vurgulanan kısımlar (noun)
hinder: engellemek, mani olmak, alıkoymak
hindered: engellenmiş, alıkonulmuş
hinterlands: iç bölgeler, art bölgeler
hiss: tıslamak, tıslama sesi
hitherto: şimdiye kadar, bugüne dek
hives: kovanlar (arı), kurdeşen (cilt hastalığı)
hoarding: istifçilik, stokçuluk, reklam panosu
hoax: aldatmaca, sahtekarlık, şaka
holographic: holografik
holster: silah kılıfı
homage: saygı duruşu, hürmet, bağlılık bildirimi
homeostasis: homeostazi, iç denge
hominin: hominin (insansı)
homogenous: homojen, türdeş, bağdaşık
homologous: homolog, eş yapılı, benzer kökenli
hone: bilemek, geliştirmek, mükemmelleştirmek
honourable: onurlu, saygıdeğer, şerefli
hormone: hormon
horns: boynuzlar, kornalar
hospitable: misafirperver, konuksever
hostage: rehine
hostile: düşmanca, hasım, saldırgan
households: hane halkları, evler
hovered: havada durdu, gezindi, etrafında dolandı
hue: renk tonu, nüans
humanise: insancıllaştırmak, insanileştirmek
humanist: hümanist, insancıl
humble: mütevazı, alçakgönüllü, basit, gösterişsiz
humdrum: monoton, sıkıcı, tekdüze
humidification: nemlendirme
humidity: nem, rutubet
humility: tevazu, alçakgönüllülük
hunch: önsezi, tahmin, kambur duruş
hunched: kamburlaşmış, eğilmiş
hurtle: hızla fırlamak, hızla gitmek
hybrid: hibrit, melez
hybridised: melezleştirilmiş, hibritlenmiş
hydrated: sulanmış, hidrate olmuş (vücut)
hydration: hidrasyon, vücudun su alması/tutması
hydroelectricity: hidroelektrik
hydropower: hidroelektrik güç, su gücü
hygiene: hijyen, temizlik, sağlık bilgisi
hymns: ilahiler
hyperactivity: hiperaktivite, aşırı hareketlilik
hypothesis: hipotez, varsayım, faraziye
hysteria: isteri, histeri
iconic: ikonik, simgesel
idealistic: idealist, ülkücü
ideological: ideolojik, düşünsel
ideology: ideoloji, düşünce yapısı
idleness: aylaklık, tembellik, boş durma
illicit: yasa dışı, gayrimeşru
illiterate: okuma yazma bilmeyen, cahil
illuminated: aydınlatılmış, ışıklandırılmış
illusion: illüzyon, yanılsama, göz aldatmacası
imagery: imgeler, betimleme, hayal gücü
imbalance: dengesizlik, orantısızlık
imitation: taklit, benzetme
immeasurably: ölçülemeyecek derecede, son derece
immensely: muazzam derecede, son derece, çok fazla
imminent: yakın, eli kulağında, olması yakın
immortalised: ölümsüzleştirilmiş
immunity: bağışıklık, muafiyet, dokunulmazlık
impact: etki, darbe, etkilemek
impairment: bozukluk, zayıflama, hasar
impartial: tarafsız, yansız, objektif
impart: vermek (bilgi, özellik), aktarmak, bildirmek
impasse: çıkmaz, açmaz, çıkmaz sokak
impending: yaklaşan, olması yakın, beklenen (genellikle olumsuz)
imperative: zorunlu, kaçınılmaz, şart, emir kipi
imperceptible: algılanamaz, fark edilemez, sezilemez
imperfections: kusurlar, eksiklikler, pürüzler
imperial: imparatorlukla ilgili, imparatorluğa ait
impermeable: geçirimsiz, su geçirmez
impersonal: kişisel olmayan, gayri şahsi, resmi, soğuk
impetuous: aceleci, düşüncesizce davranan, fevri
impiety: dinsizlik, saygısızlık (dine/kutsal şeylere)
implausible: inanılmaz, akla yatkın olmayan
implements: uygular, hayata geçirir, aletler, araçlar
implications: imalar, çıkarımlar, (olası) sonuçlar, etkiler
implicit: üstü kapalı, ima edilen, zımni
implied: ima edilen, kastedilen, üstü kapalı
impose: dayatmak, empoze etmek, zorla kabul ettirmek
impoverished: yoksullaşmış, fakirleşmiş, fakir
impressively: etkileyici bir şekilde
imprint: iz bırakmak, damgalamak, iz, etki
impromptu: doğaçlama, hazırlıksız
impulse: dürtü, itki, ani istek
impulsivity: dürtüsellik, fevrilik
impulsive: dürtüsel, fevri, düşüncesizce davranan
inability: yetersizlik, acziyet, yapamama
inaccessible: erişilemez, ulaşılamaz
inaccurate: yanlış, hatalı, doğru olmayan
inactive: etkin olmayan, pasif, hareketsiz
inadequate: yetersiz, eksik, kafi olmayan
inadvertently: yanlışlıkla, farkında olmadan, istemeden
inanimate: cansız
incentive: teşvik, özendirici şey, güdü
inception: başlangıç, başlama
incidentally: tesadüfen, bu arada, yeri gelmişken
incisions: kesikler, yarıklar
inclined: eğilimli, meyilli
inclusion: dahil etme, kapsama, içerme
inclusive: kapsayıcı, içeren, dahil
inconceivable: akıl almaz, düşünülemez, inanılmaz
inconclusive: sonuçsuz, kesin olmayan
inconsistency: tutarsızlık, uyuşmazlık
inconsistent: tutarsız, çelişkili, değişken
inconvenient: zahmetli, uygunsuz, elverişsiz
incorporate: dahil etmek, katmak, birleştirmek, içermek
incurred: (masrafa/borca) girilmiş, maruz kalınmış, üstlenilmiş
indecisive: kararsız
indefinite: belirsiz, süresiz
indemnity: tazminat, güvence, teminat
indentation: girinti, çentik
indenture: sözleşme, kontrat (çıraklık vb.)
independence: bağımsızlık
independently: bağımsız olarak, kendi başına
indestructible: yok edilemez, yıkılmaz, çok dayanıklı
indeterminacy: belirsizlik
indication: belirti, gösterge, işaret
indicator: gösterge, belirti, işaret
indicators: göstergeler, belirtiler, işaretler
indigenous: yerli, yöreye özgü
indigestible: sindirilemez, hazmedilemez
indignant: öfkeli, içerlemiş, gücenmiş
indirectly: dolaylı olarak
indispensable: vazgeçilmez, zorunlu, elzem
induce: neden olmak, sebep olmak, ikna etmek, teşvik etmek
indulgent: hoşgörülü, müsamahakar, yüz veren
industrialisation: sanayileşme, endüstrileşme
inedible: yenmez, yenilemez
ineffectiveness: etkisizlik, verimsizlik
ineptitude: beceriksizlik, yeteneksizlik, acemilik
inequality: eşitsizlik
inert: eylemsiz, hareketsiz, atıl, (kimya) inert
inescapable: kaçınılmaz
inevitable: kaçınılmaz, beklenen, zorunlu
inevitably: kaçınılmaz olarak
inexplicable: açıklanamaz, anlaşılmaz
inextricably: ayrılmaz bir şekilde, çözülmezcesine
infallible: yanılmaz, hatasız
infancy: bebeklik, başlangıç dönemi
infantry: piyade
infectious: bulaşıcı
inferences: çıkarımlar, sonuçlar
inferiority: aşağılık duygusu, düşüklük, kalitesizlik
infertile: kısır, verimsiz
infidelity: sadakatsizlik, vefasızlık
infiltration: sızma, içeri sızma, infiltrasyon
infinite: sonsuz, sınırsız
inflammation: iltihap, yangı
inflated: şişirilmiş, abartılmış, şişkin (fiyat)
inflation: enflasyon, şişme
inflection: bürünme, çekim (dilbilgisi), tonlama
inflict: vermek (acı/zarar), çektirmek, uygulamak (ceza)
influence: etki, nüfuz
influential: etkili, nüfuzlu
influx: akın, akış, içeri akma
informant: muhbir, bilgi veren kimse, haber kaynağı
infrastructure: altyapı
infringed: ihlal edilmiş, çiğnenmiş
infuriated: çok öfkeli, çileden çıkmış
ingenuity: ustalık, marifet, yaratıcılık, hüner
ingrained: kökleşmiş, yerleşmiş
ingratiate: gözüne girmek, kendini sevdirmek, yaranmak
ingredients: malzemeler, içindekiler, bileşenler
inhabited: içinde yaşanılan, meskun
inhabitants: sakinler, oturanlar, yaşayanlar
inhalation: nefes alma, soluma, içe çekme
inherent: doğasında olan, doğal, özünde var olan
inherently: doğası gereği, özünde
inheritance: miras, kalıtım
inherit: miras almak, kalıtımla almak
inherited: miras kalan, kalıtsal
inhibiting: engelleyen, ket vuran, baskılayan
initial: ilk, başlangıçtaki
initially: başlangıçta, ilk başta
initiate: başlatmak, önayak olmak, (birini) kabul etmek
initiates: başlatır, önayak olur
initiative: girişim, inisiyatif, önayak olma
inject: enjekte etmek, iğne yapmak, katmak
injustice: haksızlık, adaletsizlik
inlets: küçük körfez, girinti, giriş
innate: doğuştan gelen, fıtri
innately: doğuştan, fıtraten
innovation: yenilik, buluş, inovasyon
innovative: yenilikçi, yaratıcı
innumerable: sayısız, pek çok
inquiries: soruşturmalar, araştırmalar, sorular
inscribed: kazınmış, yazılmış, (üzerine) işlenmiş
insecure: güvensiz, emniyetsiz
insecurity: güvensizlik, emniyetsizlik
insecticides: böcek ilaçları
inseparable: ayrılmaz
insidious: sinsi, gizlice ilerleyen
insightful: anlayışlı, kavrayışlı, içgörülü
insignificant: önemsiz, anlamsız, değersiz
insistent: ısrarcı, ısrarlı
insomnia: uykusuzluk
insomniacs: uykusuzluk çekenler
inspection: denetim, teftiş, muayene
inspiration: ilham, esin
installing: kurma, yükleme, tesis etme
instance: örnek, vaka, durum
instantaneous: anlık, anında olan
instigate: kışkırtmak, başlatmak, sebep olmak
instinct: içgüdü
instinctively: içgüdüsel olarak
institutionalisation: kurumsallaşma, kuruma yerleştirme
institutionalised: kurumsallaşmış, kuruma yerleştirilmiş
instrumental: etkili, yardımcı, aracı, enstrümantal
insufficient: yetersiz, eksik
insulating: yalıtan, izole eden
insult: hakaret, aşağılama
intact: dokunulmamış, sağlam, eksiksiz
intangible: soyut, elle tutulmaz, maddi olmayan
integral: tamamlayıcı, bütünleyici, ayrılmaz, entegral
integrate: bütünleştirmek, entegre etmek, kaynaştırmak
integrated: bütünleşik, entegre, kaynaşmış
integration: bütünleşme, entegrasyon, kaynaşma
integrity: dürüstlük, bütünlük, doğruluk
intellectual: entelektüel, aydın, zihinsel
intensify: yoğunlaştırmak, şiddetlendirmek, artırmak
intensity: yoğunluk, şiddet
intensive: yoğun, şiddetli
interbreeding: melezleme, farklı türlerin çiftleşmesi
interconnected: birbirine bağlı, ilişkili
interdependence: karşılıklı bağımlılık
interdisciplinary: disiplinlerarası
interference: müdahale, karışma, parazit
interferes: müdahale eder, karışır, engel olur
interior: iç, dahili, iç mekan
interlinking: birbirine bağlanan, kenetlenen
interlocutor: muhatap, konuşmacı
interlocking: birbirine geçen, kenetlenen
intermarriage: farklı gruplar arası evlilik
intermediary: aracı, arabulucu
intermittent: aralıklı, kesik kesik
intermittently: aralıklı olarak, kesik kesik
internalisation: içselleştirme
internalised: içselleştirilmiş
internationalism: enternasyonalizm, uluslararasıcılık
interpersonal: kişilerarası
interpolation: aradeğerleme, (araya) ekleme
interpretation: yorum, yorumlama, çeviri (sözlü)
interpretive: yorumsal, yorumlayıcı
interrelated: birbiriyle ilişkili, bağlantılı
interrelationship: karşılıklı ilişki, birbirine bağlılık
interrupt: kesmek (sözünü/yayını), ara vermek, engellemek
interrupted: kesilmiş, ara verilmiş
interruption: kesinti, ara verme, engelleme
intersection: kesişim, kavşak
intertwined: iç içe geçmiş, birbirine dolanmış
intertwining: iç içe geçen, birbirine dolanan
intervene: müdahale etmek, araya girmek
intervening: araya giren, aradaki
interventions: müdahaleler, girişimler
intimacy: yakınlık, samimiyet, mahremiyet
intimate: samimi, yakın, kişisel, mahrem
intimidated: gözü korkmuş, ürkmüş, sindirilmiş
intolerance: hoşgörüsüzlük, tahammülsüzlük
intonation: tonlama, ezgi (ses)
intricate: karmaşık, girift, çapraşık
intricately: karmaşık bir şekilde, girift biçimde
intriguing: ilgi çekici, merak uyandıran
intrinsic: içsel, asıl, kendine özgü, doğasında olan
intrusion: izinsiz girme, müdahale, zorla girme
intuition: sezgi
intuitively: sezgisel olarak
invasion: istila, işgal
invasive: istilacı, yayılan, müdahaleli (tıbbi)
inventive: yaratıcı, özgün, becerikli
inventory: envanter, stok, liste
inverse: ters, karşıt, zıt
invertebrate: omurgasız
investigative: araştırmacı, soruşturmayla ilgili
investigators: müfettişler, araştırmacılar, soruşturmacılar
invigorating: canlandırıcı, dinçleştirici, kuvvet verici
invocation: dua, yakarma, çağırma (ruh vb.), (yardım) isteme
invoke: başvurmak, yardım istemek, çağırmak (ruh), (yasa) uygulamak
involuntary: istemsiz, gayriihtiyari
ironically: ironik bir şekilde, alaycı bir şekilde
irrational: irrasyonel, mantıksız, akıl dışı
irreparable: telafi edilemez, onarılamaz
irrepressible: bastırılamaz, zaptedilemez, engellenemez
irresistible: karşı konulmaz, dayanılmaz, direnilmez
irreversible: geri döndürülemez, tersinmez
irrespective: bakılmaksızın (-den), ne olursa olsun, hesaba katmadan
irrevocably: geri dönülmez biçimde, kesin olarak
irrigated: sulanmış, sulanan
irrigation: sulama
irritable: asabi, sinirli, kolay kızan, çabuk tahriş olan
irritate: rahatsız etmek, sinirlendirmek, tahriş etmek
irritating: rahatsız edici, sinir bozucu, tahriş edici
isolation: izolasyon, yalıtım, tecrit, yalnızlık
itinerary: seyahat programı, yol güzergahı
jeopardised: tehlikeye atılmış, riske atılmış
jeopardy: tehlike, risk
jigsaw: yapboz, dekupaj testeresi
journals: dergiler, günlükler, jurnaller
judicial: adli, yargısal
jurisdiction: yargı yetkisi, yetki alanı
justification: gerekçe, haklı sebep, meşrulaştırma
justifiable: haklı, meşru, mazur görülebilir
juvenile: genç, çocuksu, çocuk suçlu (noun)
keepers: koruyucular, bekçiler, bakıcılar (hayvanat bahçesi vb.), muhafızlar
kerosene: gazyağı
kickstarting: başlatma, harekete geçirme, ilk hareketi verme
kin: akraba, hısım, soy
kindred: akraba, benzer, soydaş, yakınlık (ruhsal)
kinetoscope: kinetoskop (eski film gösterme cihazı)
labour-intensive: emek yoğun
lacking: eksik, yoksun (-den)
lame: topal, zayıf, yetersiz (bahane, mazeret vb.)
landmark: dönüm noktası, önemli olay, nirengi noktası, belirgin yapı/yer
landmasses: kara kütleleri
landowners: toprak sahipleri, arazi sahipleri
lap: tur (yarış), kucak, etap, yalamak (verb)
lateral: yanal, yandan, yana doğru
latitude: enlem, hoşgörü, tolerans, hareket serbestliği
latter: ikincisi, sonraki, sonuncusu (bahsedilen iki şeyden/kişiden)
launch: başlatmak, fırlatmak, piyasaya sürmek, suya indirmek (gemi)
launched: başlatılmış, fırlatılmış, piyasaya sürülmüş
lawful: yasal, kanuni, meşru
laying: döşeme, serme, kurma, yumurtlama
layered: katmanlı, kat kat
layout: düzen, plan, yerleşim, mizanpaj, sayfa düzeni
lead-in: giriş, başlangıç, hazırlık
league: lig, birlik, fersah (eski uzunluk ölçüsü)
leasing: kiralama (genellikle uzun süreli, finansal)
legacy: miras, kalıt
legalise: yasallaştırmak, meşrulaştırmak
legislative: yasama ile ilgili, yasamaya ait
legislature: yasama organı, meclis
legitimacy: meşruiyet, yasallık
legitimate: meşru, yasal, haklı, geçerli
leisurely: acele etmeden, yavaş yavaş, rahatça
leitmotif: leitmotif, ana fikir/tema (müzik, edebiyat)
lentil: mercimek
lethal: öldürücü, ölümcül
lethargic: uyuşuk, miskin, bitkin, letarjik
liability: sorumluluk, yükümlülük, dezavantaj, borçlar (muhasebe)
libel: yazılı hakaret, iftira
liberalism: liberalizm, serbestçilik
libertarian: liberteryen, özgürlükçü
librettists: libretto yazarları (opera metni yazarı)
licensing: lisanslama, ruhsat verme
lifelike: gerçek gibi, canlı gibi, aslına çok benzeyen
lifespan: ömür, yaşam süresi
lifesaver: cankurtaran, hayat kurtaran şey/kimse
lighten: hafifletmek, aydınlatmak, neşelendirmek, rengini açmak
likelihood: olasılık, ihtimal
liken: benzetmek (-e)
limbs: uzuvlar (kollar, bacaklar), dallar (ağaç)
limestone: kireçtaşı, kalker
limitation: sınırlama, kısıtlama, limit, kısıt
limpid: berrak, şeffaf, duru
lineage: soy, nesil, köken, soy hattı
linguistics: dilbilim, lengüistik
literacy: okuryazarlık
literary: edebi, edebiyatla ilgili
literal: harfi harfine, kelimesi kelimesine, gerçek anlamlı, düz anlamlı
littered: dağınık, çöplü, (-ile) dolu/kaplı
livestock: çiftlik hayvanları, büyükbaş ve küçükbaş hayvanlar
lobbying: lobi faaliyetleri, kulis yapma, baskı grubu faaliyeti
localised: yerel, lokalize edilmiş, bölgesel, sınırlı
lodgings: konaklama yeri, pansiyon, kiralık oda/ev
loggers: oduncular, tomrukçular
logistics: lojistik, tedarik ve dağıtım yönetimi
looming: beliren, yaklaşan (genellikle tehditkar), ufukta görünen
loosely: gevşekçe, kabaca, belirsiz bir şekilde
loot: ganimet, yağma, yağmalanmış mal
lubricate: yağlamak, kayganlaştırmak
lucid: açık, anlaşılır, berrak (zihin, yazı vb.), saydam
lucrative: karlı, kazançlı, gelir getiren
luminous: parlak, ışıklı, ışık saçan
lure: cezbetmek, ayartmak, kandırmak (verb), yem, tuzak, cazibe (noun)
lush: gür, bol, verimli, yemyeşil, şatafatlı
lymph: lenf, akkan
machinists: makinistler, makine operatörleri, torna ustaları
macro: makro, büyük ölçekli
magnified: büyütülmüş, abartılmış
magnitude: büyüklük, önem, boyut, şiddet (deprem vb.)
mainframe: ana bilgisayar, merkezi işlem birimi
mainstream: ana akım, genel eğilim, yaygın görüş
maintenance: bakım, onarım, idame, koruma, nafaka
malnourished: yetersiz beslenmiş, kötü beslenmiş
mammal: memeli (hayvan)
mammograms: mamogramlar (meme röntgeni)
mammoth: mamut (noun), devasa, çok büyük, kocaman (adj)
manageable: yönetilebilir, başa çıkılabilir, idare edilebilir, kontrol edilebilir
mandatory: zorunlu, mecburi
maneuverability: manevra kabiliyeti
manifestation: tezahür, belirti, dışavurum, gösterge
manifestations: tezahürler, belirtiler, dışavurumlar
manifests: tezahür eder, gösterir, belli eder, ortaya çıkarır
manipulate: manipüle etmek, ustaca kullanmak, yönlendirmek, hileyle etkilemek
manipulating: manipüle eden, yönlendiren, ustaca kullanan
manipulation: manipülasyon, hileli yönlendirme, ustaca kullanma
manmade: insan yapımı, yapay, suni
manual: el ile yapılan, manuel, el kitabı, kullanma kılavuzu
manuscript: el yazması (eser), müsvedde
marital: evlilikle ilgili, evliliğe ait
maritime: denizcilikle ilgili, deniz, denize ait
marked: belirgin, göze çarpan, bariz, işaretli
marketable: pazarlanabilir, satılabilir, piyasası olan
marquis: marki (soyluluk unvanı)
marshlands: bataklık araziler, sazlıklar
martyrs: şehitler
marvelous: harika, müthiş, şahane, olağanüstü
mass-market: kitle pazarı, geniş tüketici kitlesine yönelik
massive: devasa, çok büyük, masif, kütlesel
mastery: ustalık, hakimiyet, hüner, uzmanlık
maternal: anneye ait, annelikle ilgili, anne tarafından (akraba), annesel
matriarch: anaerkil aile reisi, klanın/ailenin yaşlı ve saygın kadını
matriculated: üniversiteye kaydedilmiş, (kayıt için) kabul edilmiş, kayıt yaptırmış
maturation: olgunlaşma, erginleşme
mature: olgun, yetişkin, vadesi gelmiş, olgunlaşmak (verb)
maximize: en üst düzeye çıkarmak, maksimize etmek, azamileştirmek
meager: kıt, az, yetersiz, cılız
measurable: ölçülebilir
meddling: müdahale etme, burnunu sokma, (başkasının işine) karışma
mediate: arabuluculuk etmek, aracılık yapmak
mediator: arabulucu, aracı
medicinal: tıbbi, şifalı, tedavi edici
medics: sağlık görevlileri, tıp doktorları/öğrencileri
medieval: ortaçağa ait, ortaçağ
mediocre: vasat, sıradan, orta karar, pek parlak olmayan
meditation: meditasyon, derin düşünme, tefekkür
melancholy: melankoli, hüzün, keder, iç sıkıntısı
melodic: melodik, ezgili, ahenkli
melt: erimek, eritmek, yumuşamak (mecazi)
memento: hatıra, andaç, yadigâr
memoirs: anı yazıları, hatırat, anılar
menace: tehdit, tehlike, bela, baş belası
menacing: tehditkar, korkutucu, ürkütücü
mentor: akıl hocası, danışman, rehber, usta
mercenary: paralı asker (noun), çıkarcı, para canlısı, paralı (adj)
merchandise: ticari mal, eşya, ürünler
merchants: tüccarlar, tacirler
merge: birleşmek, kaynaşmak, birleştirmek, içine katmak
merging: birleşen, kaynaşan, birleşme
merit-based: liyakat esaslı, başarıya dayalı
mesmerizing: büyüleyici, hipnotize edici, göz alıcı
metabolic: metabolik, metabolizmayla ilgili
metabolism: metabolizma
metallurgy: metalürji, metal bilimi
metaphor: metafor, mecaz, istiare, eğretileme
metaphorical: metaforik, mecazi
metaphysical: metafizik, fizikötesi
meteorite: meteorit, göktaşı
meticulous: titiz, özenli, kılı kırk yaran, dikkatli
metropolitan: metropoliten, büyükşehire ait, başkente ait
microbes: mikroplar, mikroorganizmalar
microbial: mikrobiyal, mikroplara ait, mikrobik
microbiology: mikrobiyoloji
microcosms: mikrokozmoslar, küçük evrenler, küçük modeller
microelectrodes: mikroelektrotlar
microgravity: mikro yerçekimi, çok düşük yerçekimi ortamı
microhabitats: mikro habitatlar, küçük yaşam alanları
micro-invertebrate: mikro omurgasız (canlı)
microorganisms: mikroorganizmalar
microscopic: mikroskobik, çok küçük
microscopy: mikroskopi (mikroskopla inceleme bilimi/tekniği)
migration: göç
migratory: göçmen, göç eden, göçle ilgili
militant: militan, savaşçı, mücadeleci, saldırgan (tutum)
milking: sağma (süt), sömürme (mecazi)
millennia: binyıllar (millennium'un çoğulu)
millionths: milyonda birler
mimic: taklit etmek (verb), taklitçi (noun), taklit (adj)
mindful: dikkatli, özenli, farkında (-nın), bilinçli
mindless: akılsız, anlamsız, düşüncesiz, beyhude, amaçsız
minefield: mayın tarlası, tehlikeli/karmaşık durum, riskli alan
mineralogy: mineraloji, mineral bilimi
miniaturize: küçültmek, minyatürleştirmek
minimal: asgari, minimum
minimise: en aza indirmek, minimize etmek
minimum: minimum, asgari
minted: basılmış, darp edilmiş (para), yeni zengin olmuş (argo)
minutely: detaylı olarak, dikkatle, titizlikle
minuscule: küçücük, minnacık, miniskül
miscalculation: yanlış hesaplama, hesap hatası
misclassifying: yanlış sınıflandıran
misconception: yanlış kanı, yanlış anlama, yanılgı
misinterpreted: yanlış yorumlanmış
misleading: yanıltıcı, aldatıcı
misperceptions: yanlış algılar, yanlış izlenimler
mistakenly: yanlışlıkla, sehven
misstatement: yanlış ifade, gerçeğe aykırı beyan
mistreatment: kötü muamele, eziyet
mites: akarlar, maytlar
mitigation: hafifletme, azaltma, yatıştırma
mitochondrial: mitokondriyal
mobilise: seferber etmek, harekete geçirmek
mobility: hareketlilik, mobilite
mock: alay etmek, taklit etmek, sahte, taklit (adj)
modality: tarz, yöntem, modalite, kip
moderating: ılımlı hale getiren, yatıştıran, dengeleyen
modular: modüler, parçalı
moisture: nem, rutubet
molded: kalıplanmış, şekil verilmiş
molecular: moleküler
molecules: moleküller
momentum: momentum, hız, ivme
monarchists: monarşistler, kraliyet yanlıları
monarchy: monarşi, krallık
monetary: parasal, mali
monitor: izlemek, gözlemlemek, monitör (noun)
monitoring: izleme, gözlemleme, takip etme
monolingual: tek dilli
monolingualism: tek dillilik
monolithic: monolitik, tek parça, yekpare
monotremes: monotremler, tek delikliler (biyoloji)
monotonous: monoton, tekdüze, sıkıcı
monumental: anıtsal, devasa, çok büyük
mood-boosting: neşelendiren, morali yükselten
morality: ahlak, maneviyat, etik
mortar: harç (inşaat), havan (mutfak/silah)
mortgage: ipotek, konut kredisi
mosaics: mozaikler
mosaic: mozaik
motif: motif, tema, ana fikir
motivation: motivasyon, güdülenme, teşvik
motives: güdüler, nedenler, amaçlar, niyetler
motto: slogan, parola, ilke, özdeyiş
mouthing: dudak oynatarak söyleme, ağız hareketleri yapma
multifaceted: çok yönlü, çok yüzlü
multifunctional: çok fonksiyonlu, çok işlevli
multilingualism: çok dillilik
multimedia: multimedya, çoklu ortam
multisensory: çok duyulu, birden fazla duyuya hitap eden
multitude: çokluk, kalabalık, yığın
municipal: belediyeye ait, kentsel
murky: bulanık, karanlık, şaibeli, şüpheli
musculoskeletal: kas-iskelet (sistemiyle ilgili)
mutations: mutasyonlar, değişimler
mutual: karşılıklı, ortak, müşterek
mutually: karşılıklı olarak, birbirine, ortaklaşa
mycoheterotrophs: mikoheterotroflar (biyoloji)
myelination: miyelinasyon, miyelinleşme (biyoloji)
mysterious: gizemli, esrarengiz
mysteriousness: gizemlilik, esrarengizlik
myth: mit, efsane, asılsız inanç
mythical: efsanevi, mitsel, hayali
mythological: mitolojik
mythology: mitoloji
myths: mitler, efsaneler, asılsız inançlar
naive: saf, naif, deneyimsiz
narratives: anlatılar, hikayeler, öyküler
nasal: burunla ilgili, nazal, genizsil
nationalism: milliyetçilik, ulusçuluk
natively: yerel olarak, doğuştan, ana dili olarak
naturalistic: doğalcı, natüralist
naught: hiç, sıfır
nautical: denizcilikle ilgili, denizsel
navigable: gemilerin seyrine uygun, geçilebilir (su yolu)
navigation: navigasyon, seyir, yön bulma
negligence: ihmal, ihmalkarlık
negligible: ihmal edilebilir, önemsiz, cüzi
negotiate: müzakere etmek, görüşmek, pazarlık etmek
neolithic: neolitik, cilalı taş devri, yeni taş çağı
nerve: sinir, cesaret, cüret
neurological: nörolojik, sinirsel
neurologists: nörologlar, sinir hastalıkları uzmanları
neuromelanin: nöromelanin (biyoloji)
neurons: nöronlar, sinir hücreleri
neuroplasticity: nöroplastisite, sinirsel esneklik
neuroscience: nörobilim, sinirbilim
neuroscientists: nörobilimciler, sinirbilimciler
neuroticism: nevrotiklik, duygusal dengesizlik
neutral: nötr, tarafsız, yansız
neutralise: nötralize etmek, etkisiz hale getirmek, tarafsızlaştırmak
newcomer: yeni gelen, acemi
niche: niş, uygun yer/konum, (pazarda) özel alan
niceties: incelikler, nezaket kuralları, ayrıntılar
nightfall: akşam karanlığı, gün batımı
nimble: çevik, atik, kıvrak
nitrate: nitrat
nocturnal: gececil, gece faal olan
nomadic: göçebe, göçer
nomads: göçebeler, göçerler
nominate: aday göstermek, atamak
nominated: aday gösterilmiş, atanmış
non-biological: biyolojik olmayan
nonconformity: uymama, aykırılık, nonkonformizm
non-dairy: sütsüz, süt ürünü içermeyen
non-fiction: kurgusal olmayan, gerçeklere dayalı (yazı)
non-inclusive: kapsayıcı olmayan, dışlayıcı
non-invasive: non-invaziv, girişimsel olmayan (tıp)
non-literate: okuryazar olmayan
non-refundable: iade edilemez, geri ödemesiz
non-renewable: yenilenemez
non-representational: temsili olmayan, soyut (sanat)
non-stick: yapışmaz
non-traditional: geleneksel olmayan
non-verbal: sözsüz, sözel olmayan
norm: norm, kural, standart
notable: dikkate değer, önemli, tanınmış, göze çarpan
notably: özellikle, bilhassa, dikkat çekici bir şekilde
noteworthy: kayda değer, dikkate değer
notion: kavram, fikir, düşünce, kanı
notoriously: adı kötüye çıkmış bir şekilde, kötü şöhretli olarak
notorious: adı kötüye çıkmış, kötü şöhretli
nourish: beslemek, gıda vermek, büyütmek
nourishment: beslenme, gıda, besin
novel: yeni, özgün, alışılmadık (adj), roman (noun)
novelty: yenilik, orijinallik, tuhaflık
novices: acemiler, yeni başlayanlar, çömezler
nuclear: nükleer, çekirdeksel
nucleus: çekirdek (hücre, atom vb.)
nudge: hafifçe dürtmek, dirseklemek, teşvik etmek
nurture: beslemek, büyütmek, geliştirmek, yetiştirmek
nurturing: besleyici, geliştirici, şefkatli, bakıcı
nutrients: besin maddeleri, besinler
nutrition: beslenme, gıda
nutritional: besinsel, beslenme ile ilgili
oath: yemin, ant
obesity: obezite, aşırı şişmanlık
objective: amaç, hedef (noun), nesnel, objektif, tarafsız (adj)
objectively: nesnel olarak, objektif bir şekilde, tarafsızca
objectivity: nesnellik, objektiflik, tarafsızlık
oblivious: habersiz, farkında olmayan (-den habersiz)
obscured: gizlenmiş, perdelenmiş, anlaşılması zorlaştırılmış
observation: gözlem, müşahade, yorum, beyan
observatory: gözlemevi, rasathane
obsession: takıntı, saplantı, obsesyon
obsessive: takıntılı, saplantılı, obsesif
obsessive-compulsive: obsesif-kompulsif, takıntılı-zorlantılı
obsolete: modası geçmiş, eskimiş, kullanılmayan
obstacle: engel, mani, köstek
obstinate: inatçı, dik kafalı, dediğim dedik
obtain: elde etmek, sağlamak, edinmek, almak
obviate: gereksiz kılmak, ortadan kaldırmak, önlemek
obvious: açık, bariz, aşikar, belli
occasionally: ara sıra, bazen, zaman zaman
occupation: meslek, iş, işgal, meşguliyet
occupational: mesleki, işle ilgili
occupy: işgal etmek, meşgul etmek, (yer) tutmak
offenders: suçlular, suç işleyenler, ihlal edenler
offensive: saldırgan, hakaretamiz, kırıcı, nahoş, saldırı (noun)
offending: suç işleyen, rahatsız eden, kırıcı, söz konusu
offshore: kıyıdan açıkta, denizaşırı, ülke dışı
offspring: yavrular, çocuklar, döl, nesil
olfactory: koku alma ile ilgili, kokuya ait, olfaktör
omen: alamet, işaret, kehanet (genellikle olumsuz)
ominous: uğursuz, meşum, kötüye işaret eden
omit: atlamak, çıkarmak, dahil etmemek, ihmal etmek
omniscience: her şeyi bilme, mutlak bilgi
on behalf of: adına, namına, temsilen
onlookers: seyirciler, izleyenler, bakanlar
onset: başlangıç, başlama (genellikle olumsuz bir şeyin)
opaque: opak, mat, donuk, anlaşılmaz, kapalı
operational: operasyonel, işler durumda, faal, kullanıma hazır
opioids: opioidler
opponents: rakipler, muhalifler, karşıtlar
opposed: karşı, muhalif, zıt (-e karşı)
opposing: karşı çıkan, muhalif, zıt, rakip
oppression: baskı, zulüm, eziyet
optimal: optimal, en uygun, en iyi
optimise: optimize etmek, en uygun hale getirmek, en iyi şekilde kullanmak
optimistic: iyimser, optimist
optional: isteğe bağlı, seçmeli, opsiyonel
oral: sözlü, ağızdan, ağızla ilgili
orchestrated: orkestra tarafından çalınan, planlanmış, organize edilmiş
orchestra: orkestra
ordeal: çile, zorlu deneyim, meşakkat
ore: maden cevheri, filiz
organism: organizma, canlı varlık
organoid: organoid, organ benzeri yapı
orientation: yönelim, oryantasyon, eğilim, bilgilendirme toplantısı
originated: kaynaklandı, köken aldı, başladı (-den/-dan)
ornate: süslü, şatafatlı, gösterişli, ağdalı (üslup)
orthodoxy: ortodoksluk, gelenekçilik, genel kabul
orthorexia: ortoreksiya (sağlıklı beslenme takıntısı)
oscillate: salınmak, tereddüt etmek, dalgalanmak, gidip gelmek
ostracised: dışlanmış, toplum dışına itilmiş
oust: görevden almak, yerinden etmek, kovmak
outbreak: salgın, patlak verme
outbursts: patlamalar (duygu), ani çıkışlar
outcome: sonuç, netice
outdated: modası geçmiş, güncelliğini yitirmiş
outdistance: geride bırakmak, geçmek
outlaw: kanun kaçağı, haydut (noun), yasaklamak (verb)
outlets: satış noktaları, mağazalar, prizler, ifade yolları
outlier: aykırı değer, dışta kalan
outmoded: modası geçmiş, köhne
outnumber: sayıca üstün olmak, sayıca geçmek
outperform: daha iyi performans göstermek, (-den) daha başarılı olmak
outrageous: aşırı, çirkin, kabul edilemez, şok edici
outskirts: kenar mahalleler, şehrin dışı
outsmart: aklıyla yenmek, zekasıyla alt etmek
outweigh: daha ağır basmak, -den daha önemli olmak
overcoming: üstesinden gelme, aşma
overeating: aşırı yeme, fazla yeme
overemphasise: aşırı vurgulamak, fazla önemsemek
overestimation: aşırı tahmin, gözünde büyütme
overexposure: aşırı maruz kalma, fazla pozlama (fotoğrafçılık)
overfed: aşırı beslenmiş, fazla yedirilmiş
overfertilisation: aşırı gübreleme
overfishing: aşırı avlanma (balık)
overharvesting: aşırı hasat, aşırı toplama
overhaul: elden geçirmek, revizyondan geçirmek (verb), revizyon, genel bakım (noun)
overhead: baş üstü, havai (adj/adv), genel giderler (noun)
overlap: üst üste binmek, çakışmak (verb), örtüşme, çakışma (noun)
overlook: gözden kaçırmak, görmezden gelmek, -e nazır olmak (manzara)
overlooked: gözden kaçırılmış, ihmal edilmiş
overparenting: aşırı ebeveynlik, helikopter ebeveynlik
overpopulation: aşırı nüfus, nüfus fazlalığı
overprescription: aşırı ilaç yazma, gereksiz reçeteleme
overreact: aşırı tepki vermek
oversee: denetlemek, gözetmek, nezaret etmek
overshadow: gölgede bırakmak, geri plana itmek
overt: açık, aleni, aşikar
overturn: devirmek, alabora etmek, (kararı) bozmak, iptal etmek
overuse: aşırı kullanmak (verb), aşırı kullanım (noun)
overweight: aşırı kilolu, fazla kilolu
paddock: padok, küçük çayır (at vb. için)
paediatric: pediatrik, çocuk hastalıklarıyla ilgili
paediatrician: pediatrist, çocuk doktoru
paediatrics: pediatri, çocuk sağlığı ve hastalıkları
paleogeneticists: paleogenetikçiler (eski DNA uzmanları)
paleoanthropological: paleoantropolojik
paleontology: paleontoloji, fosil bilimi
palpable: elle tutulur, hissedilir, aşikar
paltry: önemsiz, değersiz, cüzi
panacea: her derde deva
papyrus: papirüs
parachuting: paraşütle atlama
paradox: paradoks, çelişki
paradoxically: paradoksal olarak, çelişkili bir şekilde
paralysed: felçli, felç olmuş
paralysis: felç, inme
paralysing: felç edici, hareketsiz bırakan
paramilitary: paramiliter, yarı askeri
parasite: parazit, asalak
parasitic: parazitik, asalak
parchment: parşömen
parenting: ebeveynlik, çocuk yetiştirme
parity: eşitlik, denklik, parite
parkour: parkur (spor)
parliament: parlamento, meclis
partial: kısmi, taraflı
partially: kısmen
participate: katılmak, iştirak etmek
particulates: partiküller, tanecikler (hava kirliliği vb.)
partisanship: tarafgirlik, particilik
partition: bölme, ayırma (noun), bölmek, ayırmak (verb)
pastime: hobi, eğlence, meşgale
pastoral: pastoral, kırsal, çobanlıkla ilgili
pastures: meralar, otlaklar
patch: yama, küçük alan/parça, (yazılım) yama
patchwork: kırkyama, karmaşık yapı
patented: patentli, patenti alınmış
pathogen: patojen, hastalık yapıcı
pathological: patolojik, hastalıklı, marazi (mecazi)
patriarchy: ataerkillik
patrolling: devriye gezme
paucity: azlık, kıtlık, yetersizlik
paved: döşeli, kaplanmış (yol vb.)
pawn: piyon (satranç), piyon, alet (mecazi)
peculiar: tuhaf, garip, özgü, has (-e)
pedagogical: pedagojik, eğitsel
peer: akran, yaşıt (noun), dikkatle bakmak (verb)
penalties: cezalar, yaptırımlar, penaltılar (spor)
penetrate: nüfuz etmek, içine işlemek, girmek
penetrating: nüfuz eden, delici, keskin (zeka, bakış vb.)
penicillin: penisilin
perceive: algılamak, sezmek, farkına varmak
perception: algı, algılama, idrak
perceptual: algısal
percussion: perküsyon, vurmalı çalgılar
perennial: çok yıllık (bitki), sürekli, daimi
perfected: mükemmelleştirilmiş, kusursuzlaştırılmış
perfectionism: mükemmeliyetçilik
perfunctory: baştan savma, üstünkörü
perilous: tehlikeli, riskli
peripheral: çevresel, ikincil, önemsiz, periferik
perish: yok olmak, ölmek, çürümek, bozulmak (gıda)
perishable: kolay bozulan, dayanıksız (gıda vb.)
permanence: kalıcılık, devamlılık
permeable: geçirgen, geçirimli
permeate: nüfuz etmek, içine işlemek, yayılmak
permissible: izin verilebilir, caiz, müsaade edilebilir
perpetuate: sürdürmek, devam ettirmek
perpetrators: failler, suçlular
perpetual: sürekli, daimi, ebedi
perplexed: şaşkın, kafası karışmış
persecution: zulüm, eziyet, baskı
perseverance: sebat, azim, kararlılık
persistence: ısrar, süreklilik, kalıcılık
personnel: personel, kadro, elemanlar
perspective: bakış açısı, perspektif
persuades: ikna eder, razı eder
persuasively: ikna edici bir şekilde
pertains: ilgili olmak, ait olmak (-e)
pertinent: ilgili, alakalı, uygun
pervasive: yaygın, her tarafa yayılmış
pessimism: kötümserlik, karamsarlık
pessimistic: kötümser, karamsar
pest: haşere, zararlı böcek, baş belası (mecazi)
pesticide: pestisit, böcek ilacı, tarım ilacı
petition: dilekçe, istirham (noun), dilekçe vermek (verb)
petroleum: petrol
pharaoh: firavun
pharmaceutical: farmasötik, eczacılıkla ilgili (adj), ilaç (noun)
pharmacological: farmakolojik
phenomena: fenomenler, olgular, olaylar (phenomenon'un çoğulu)
phenomenon: fenomen, olgu, olay, harika, olağanüstü şey/kişi
philanthropic: hayırsever, insancıl
philopatric: filopatrik (doğduğu yere bağlı kalan - hayvan)
phobia: fobi, korku
phonological: fonolojik, ses bilimsel
phosphates: fosfatlar
photoreceptors: fotoreseptörler, ışık alıcılar (gözde)
photosynthesis: fotosentez
physiotherapy: fizyoterapi, fizik tedavi
picturesque: pitoresk, tablo gibi
pierce: delmek, delip geçmek
pigment: pigment, renk maddesi
pilgrimage: hac, kutsal yolculuk
pills: haplar, tabletler
pinpoint: tam yerini saptamak (verb), kesin, tam (adj)
pioneer: öncü (noun), öncülük etmek (verb)
piracy: korsanlık (deniz), korsanlık, izinsiz çoğaltma (fikri mülkiyet)
pistons: pistonlar
pivotal: çok önemli, kilit, merkezi
placebo: plasebo, etkisiz ilaç
placard: pankart, afiş, levha
plague: veba (hastalık), bela, musibet (noun), rahatsız etmek (verb)
plaintiff: davacı
plankton: plankton
plausible: makul, akla yatkın
playwright: oyun yazarı
plea: yalvarma, rica, (hukuk) savunma, iddia
plethora: aşırı bolluk, fazlalık
pliable: esnek, bükülebilir, uysal
plight: zor durum, kötü durum, çıkmaz
plumage: (kuş) tüyleri
plummet: hızla düşmek, dikine düşmek, çakılmak
plunder: yağmalamak, talan etmek (verb), yağma, talan (noun)
plunge: (hızla) dalmak, atlamak, aniden düşmek (fiyat vb.)
pneumonia: zatürre, pnömoni
poignant: dokunaklı, acıklı, içe işleyen
poised: dengeli, kendinden emin, hazır (-e)
polishing: parlatma, cilalama
pollinator: polenleyici, tozlaştırıcı
pollutants: kirleticiler, kirletici maddeler
polluters: kirletenler
polygraph: poligraf, yalan makinesi
ponds: göletler
portals: portallar, giriş kapıları, web portalları
portent: alamet, işaret, kehanet
portion: porsiyon, kısım, pay
portray: tasvir etmek, betimlemek, canlandırmak
portrayal: tasvir, betimleme, canlandırma
posed: (sorun vb.) teşkil eden, yaratan, poz vermiş
post-traumatic: travma sonrası
postnatal: doğum sonrası, postnatal
postulate: varsaymak, öne sürmek (verb), varsayım (noun)
posture: duruş (vücut), tavır, tutum
potency: etki gücü, tesir, potansiyel, iktidar (cinsel)
potent: güçlü, etkili, tesirli
potential: potansiyel, olası (adj), potansiyel, gizli güç (noun)
poultry: kümes hayvanları
poverty: yoksulluk, fakirlik
practitioner: uygulayıcı, pratisyen (hekim), meslek erbabı
pragmatic: pragmatik, uygulamacı, pratik, faydacı
praiseworthy: övgüye değer, takdire şayan
precaution: önlem, tedbir
precede: (-den) önce gelmek
precedent: emsal, örnek olay
precipitated: hızlandırılmış, neden olunmuş, çökelmiş (kimya)
precipitation: yağış (hava), çökelti, çökelme (kimya)
precision: kesinlik, hassasiyet, doğruluk
precursor: öncü, haberci, öncül (madde)
predatory: yırtıcı, avcı, yağmacı
predate: daha önce gelmek, -den önceki tarihte olmak
predecessor: selef, önceki, öncül
predetermine: önceden belirlemek, önceden kararlaştırmak
predetermined: önceden belirlenmiş, önceden kararlaştırılmış
predicament: zor durum, çıkmaz, açmaz
predict: tahmin etmek, öngörmek, kehanette bulunmak
predictable: tahmin edilebilir, öngörülebilir
predicting: tahmin etme, öngörme
predisposition: yatkınlık, eğilim, meyil
predominant: baskın, hakim, egemen, ağır basan
preface: önsöz, giriş, başlangıç
preference: tercih, yeğleme
prehistoric: tarih öncesi
prejudice: önyargı
preliminary: ön, hazırlık niteliğinde, başlangıç
prelude: giriş, başlangıç, prelüd
premature: erken, zamansız, vaktinden önce
premise: öncül, varsayım, dayanak noktası, (bina ve arazisi) mülk
preoccupations: kafa meşguliyetleri, endişeler, saplantılar
prerequisites: ön koşullar, ön şartlar, gerekler
prescribe: reçete yazmak, buyurmak, emretmek, (kural) koymak
prescribed: öngörülen, belirlenen, reçeteyle verilen
preservation: koruma, muhafaza etme
preserved: korunmuş, muhafaza edilmiş
prestige: prestij, saygınlık, itibar
prestigious: prestijli, saygın, itibarlı
presumably: muhtemelen, galiba, tahminen
presume: varsaymak, farz etmek, sanmak, cüret etmek
presumption: varsayım, karine, küstahlık, cüret
prevalence: yaygınlık, sıklık, geçerlilik
prevalent: yaygın, sık görülen, hakim
primate: primat (memeli takımı)
primitive: ilkel, basit, gelişmemiş
primarily: öncelikle, başlıca, esasen
principal: ana, temel, başlıca, okul müdürü
principle: prensip, ilke, esas
prioritise: öncelik vermek, önceliklendirmek
pristine: bozulmamış, el değmemiş, saf, tertemiz
privileged: ayrıcalıklı, imtiyazlı
probability: olasılık, ihtimal
probing: sondaj yapan, araştıran, irdeleyen
procedure: prosedür, işlem, yöntem, usul
proceeding: ilerleyen, devam eden, yargılama, dava (çoğul: proceedings)
proclaim: ilan etmek, duyurmak, beyan etmek
procrastinate: ertelemek, ağırdan almak, savsaklamak
procrastination: erteleme, savsaklama, işi ağırdan alma
procreative: üreme ile ilgili, doğurgan
procuring: tedarik etme, sağlama, elde etme
prodigies: harikalar, dahiler, olağanüstü yetenekler
prodigy: dahi çocuk, harika, mucize
profound: derin, engin, büyük, esaslı
profoundly: derinden, son derece, büyük ölçüde
profusion: bolluk, çokluk, aşırılık
progression: ilerleme, gelişme, dizi, artış
progressively: giderek, artan bir şekilde, aşamalı olarak
prohibit: yasaklamak, menetmek
prohibited: yasak, yasaklanmış
prohibition: yasak, yasaklama
proliferation: hızla çoğalma, yayılma
prolific: üretken, verimli, doğurgan
prolonged: uzun süreli, uzatılmış
prominence: öne çıkma, göze çarpma, belirginlik, şöhret
prominent: öne çıkan, seçkin, belirgin, mühim
promoter: destekleyici, organizatör, teşvik eden (kimse/şey)
prompted: teşvik edilen, harekete geçirilen, -e sevk edilen
promptly: derhal, hemen, çabucak, tam vaktinde
prone: eğilimli, yatkın (-e), yüzükoyun yatmış
pronouncement: resmi açıklama, beyan, bildiri
propagate: yaymak (fikir vb.), çoğaltmak (bitki), üremek
propel: itmek, ileri sürmek, sevketmek
proponents: savunucular, taraftarlar, destekçiler
proportional: orantılı, oransal
proportionally: orantılı olarak
proportionate: orantılı, mütenasip
proposed: önerilen, teklif edilen
proposition: öneri, teklif, önerme (mantık)
prose: düzyazı, nesir
prosocial: sosyal yanlısı, toplum yararına
prospects: olasılıklar, ihtimaller, beklentiler, umutlar
prosperity: refah, zenginlik, bolluk
prosperous: müreffeh, zengin, başarılı, gelişen
protagonist: başkahraman, protagonist, öncü
protectionist: korumacı, himayeci (ekonomi)
prototype: prototip, ilk örnek, model
prototypes: prototipler, ilk örnekler
protracted: uzamış, uzun süren
protruding: çıkıntılı, fırlak, dışarı taşan
proven: kanıtlanmış, ispatlanmış
provided: şartıyla, koşuluyla, eğer, sağlanan
provoke: kışkırtmak, provoke etmek, neden olmak, uyandırmak (duygu)
provocation: kışkırtma, provokasyon, tahrik
prowess: ustalık, maharet, yiğitlik, hüner
proximity: yakınlık (mekansal)
pseudoscience: sözde bilim, sahte bilim
psychiatric: psikiyatrik
psychiatrist: psikiyatrist, ruh hekimi
psychic: psişik, ruhsal, medyum
psycholinguistics: psikodilbilim, ruh dilbilimi
psychologists: psikologlar
psychometrics: psikometri (ruhsal ölçümleme)
psychopathology: psikopatoloji (ruhsal bozukluk bilimi)
psychopharmacology: psikofarmakoloji (ruhsal ilaç bilimi)
psychosomatic: psikosomatik (ruhsal kaynaklı bedensel)
psychotherapeutic: psikoterapötik, ruhsal tedavi ile ilgili
psychotherapists: psikoterapistler
psychotherapy: psikoterapi, ruhsal tedavi
puberty: ergenlik çağı, buluğ
publicly: alenen, halka açık olarak, kamuoyu önünde
published: yayınlanmış, basılmış
pulleys: makaralar, kasnaklar
pumps: pompalar (noun), pompalar (verb)
punctuality: dakiklik, zamanında olma
pundits: uzmanlar, bilirkişiler, yorumcular
punishable: cezalandırılabilir, cezayı gerektiren
punishers: cezalandırıcılar
purely: tamamen, sadece, sırf
purification: arıtma, saflaştırma, temizleme
purify: arıtmak, saflaştırmak, temizlemek
pursuit: takip, kovalama, arayış, peşinde olma, uğraş
purview: yetki alanı, görev alanı, kapsam
put aside: bir kenara koymak, ayırmak (para vb.), bir kenara bırakmak (sorun vb.)
put forth: ileri sürmek, ortaya atmak (fikir, öneri)
put off: ertelemek, sonraya bırakmak, caydırmak, soğutmak
pyramids: piramitler
quadrangle: dörtgen (alan), avlu (genellikle kare/dikdörtgen)
quadrupedal: dört ayaklı
quaint: şirin, hoş (eskiliğiyle), antika, tuhaf
qualified: nitelikli, vasıflı, yetkili, koşullu, sınırlı
qualitative: nitel, kalitatif
quantified: nicelleştirilmiş, miktarı belirlenmiş
quantify: nicelleştirmek, miktarını belirlemek, ölçmek
quantifiable: nicelleştirilebilir, ölçülebilir (miktar olarak)
quantitatively: nicel olarak, miktar bakımından
quarantine: karantina
quarried: taş ocağından çıkarılmış
quarry: taş ocağı, av, avlanan hayvan
quarter: çeyrek, bölge, mahalle, üç aylık dönem, konaklama yeri
quench: gidermek (susuzluğu), söndürmek (ateşi), bastırmak (arzuyu)
quest: arayış, araştırma, macera
questionable: şüpheli, kuşkulu, tartışılır
quibble: önemsiz itirazlarda bulunmak, lafı çevirmek, kaçamak cevap vermek
quickened: hızlanmış, canlanmış
quintessentially: tam anlamıyla, özünde, tipik olarak
quota: kota, kontenjan, pay
radial: radyal, ışınsal, yarıçap doğrultusunda
radiation: radyasyon, ışınım
radical: radikal, köklü, kökten, aşırı
radically: kökten, tamamen, radikal bir şekilde
radiocarbon: radyokarbon
radiometer: radyometre, ışınımölçer
rags: paçavralar, eski püskü giysiler
raiding: baskın yapma, yağmalama
ramification: dallanma, sonuç, etki, uzantı
ramps: rampalar, eğimli yollar
rancher: çiftlik sahibi (büyükbaş hayvan), rençper
ratification: onaylama, tasdik etme (anlaşma vb.)
rationales: gerekçeler, mantıksal dayanaklar
reanimate: yeniden canlandırmak, diriltmek
reassured: içi rahatlatılmış, güvence verilmiş
rebellion: isyan, başkaldırı
rebirth: yeniden doğuş, diriliş, rönesans
recalcitrant: inatçı, serkeş, dik başlı, direnen
recall: hatırlamak, anımsamak, geri çağırmak, geri çekmek (ürün)
recede: çekilmek, geri gitmek, azalmak
receding: çekilen, gerileyen, azalan
receipt: makbuz, fiş, alma, teslim alma
receptive: alıcı, açık fikirli, anlayışlı (-e karşı)
reciprocal: karşılıklı, mütekabil
reciprocity: karşılıklılık, mütekabiliyet
recital: resital, dinleti, anlatma, sayıp dökme
recognition: tanıma, tanınma, takdir, onaylama
recognisable: tanınabilir
recollect: hatırlamak, anımsamak
recollection: hatıra, anımsama, hatırlama
reconciliation: uzlaşma, barışma, bağdaştırma
reconfiguration: yeniden yapılandırma, yeniden düzenleme
reconnaissance: keşif, keşif faaliyeti
reconsider: yeniden düşünmek, tekrar gözden geçirmek
reconstruct: yeniden inşa etmek, yeniden yapılandırmak, yeniden canlandırmak (olayı)
recourse: başvurma, çareye başvurma, yardım isteme (-e)
recreate: yeniden yaratmak, yeniden canlandırmak, eğlenmek, dinlenmek
recreational: eğlence amaçlı, dinlenme ile ilgili
recruitment: işe alım, askere alma, üye kaydetme
rectangular: dikdörtgen şeklinde
rectify: düzeltmek, doğrultmak, gidermek (hata vb.)
recurrence: tekrar etme, nüksetme, yinelenme
recurring: tekrarlayan, nükseden, yinelenen
recycling: geri dönüşüm
redemption: kurtuluş, kefaret, (borçtan) kurtarma, geri satın alma
redundancy: fazlalık, gereksizlik, işten çıkarma (fazlalık nedeniyle)
redundant: gereksiz, lüzumsuz, fazla, işten çıkarılmış (fazlalık nedeniyle)
re-enact: yeniden canlandırmak (olayı), yeniden yasalaştırmak
re-evaluate: yeniden değerlendirmek
referees: hakemler
refine: arıtmak, saflaştırmak, inceltmek, geliştirmek
refinement: arıtma, saflaştırma, incelik, zariflik, gelişmişlik
reflective: yansıtıcı, düşünceli, derin düşünen
reflexes: refleksler
reflexively: refleks olarak, düşünmeden, dönüşlü olarak (dilbilgisi)
reforms: reformlar
refraining: kaçınma, sakınma, çekinme
refuge: sığınak, barınak, iltica
refund: geri ödeme, iade
refute: çürütmek, aksini ispatlamak, yalanlamak
regarded: kabul edilen, sayılan, olarak görülen
regenerate: yenilemek, yeniden oluşturmak, rejenere etmek
regeneration: yenilenme, yeniden oluşma, rejenerasyon
regiment: alay (askeri)
regions: bölgeler, yöreler
registration: kayıt, tescil
regress: gerilemek, geriye gitmek
regulate: düzenlemek, ayarlamak, kontrol etmek
regulation: düzenleme, yönetmelik, kural
regurgitate: (yiyeceği) geri çıkarmak, ezberden tekrarlamak
rehabilitation: rehabilitasyon, iyileştirme, ıslah
rehearsal: prova
reign: hüküm sürme, saltanat, egemenlik
reimbursed: geri ödenmiş, masrafı karşılanmış
reintroduced: yeniden tanıtılmış, yeniden sokulmuş, tekrar uygulamaya konmuş
reinvigorated: canlandırılmış, yeniden güçlendirilmiş
reiterate: tekrarlamak, yinelemek
rejection: ret, reddetme, geri çevirme
rejuvenate: gençleştirmek, canlandırmak, yenilemek
relapsed: (hastalığı) nüksetmiş, gerilemiş
relate: ilişkilendirmek, bağlamak, anlatmak
relational: ilişkisel, bağıntısal
relativity: görelilik, izafiyet
relegated: daha alt sıraya indirilmiş, küme düşürülmüş
relentless: amansız, durmak bilmeyen, sürekli
relevant: ilgili, alakalı, konuyla ilgili
reliability: güvenilirlik, sağlamlık
reliance: güven, itimat, bel bağlama, dayanma
relics: kalıntılar, kutsal emanetler, yadigarlar
relieved: rahatlamış, ferahlamış
relinquish: vazgeçmek, bırakmak, feragat etmek
reluctant: isteksiz, gönülsüz
remainder: kalan, geri kalan, artık
remains: kalıntılar, ceset, geri kalanlar
remarkable: dikkate değer, olağanüstü, göze çarpan
remarkably: dikkate değer biçimde, oldukça, şaşırtıcı derecede
remediation: düzeltme, iyileştirme, telafi
remnant: kalıntı, artık, bakiye
remnants: kalıntılar, artıklar
remote: uzak, ücra
remotely: uzaktan, azıcık bile
removal: kaldırma, çıkarma, uzaklaştırma
renaissance: rönesans, yeniden doğuş
render: hale getirmek, kılmak, sunmak, vermek
rendered: hale getirilmiş, kılınmış, sunulmuş
renowned: ünlü, meşhur, tanınmış
rented: kiralanmış
reorganise: yeniden düzenlemek, yeniden organize etmek
repair: tamir etmek, onarmak, tamir, onarım
repeal: yürürlükten kaldırmak, feshetmek, fesih
repel: püskürtmek, itmek, iğrendirmek
repentance: pişmanlık, tövbe
repertoire: repertuar
repercussions: olumsuz sonuçlar, yansımalar, yankılar
repetitive: tekrarlayan, tekdüze
replicated: kopyalanmış, çoğaltılmış, tekrarlanmış
representation: temsil, temsil etme, betimleme
representational: temsili, betimsel
repress: bastırmak, baskı altına almak
repression: bastırma, baskı
reproductive: üreme ile ilgili, üreme
reproduce: üremek, çoğalmak, kopyalamak, yeniden üretmek
repudiate: reddetmek, tanımamak, kabul etmemek, yadsımak
reputation: itibar, ün, şöhret
request: istek, talep, rica, istemek, rica etmek
requirement: gereklilik, şart, ihtiyaç
requisites: gerekli şeyler, gereklilikler, şartlar
rescue: kurtarmak, kurtarma
researchers: araştırmacılar
resemblance: benzerlik, andırma
reservations: rezervasyonlar, çekinceler, kuşkular
reservoirs: rezervuarlar, su depoları, baraj gölleri
residing: ikamet eden, oturan
residual: kalıntı, artık, geri kalan
resigned: kabullenmiş, boyun eğmiş, istifa etmiş
resilience: dayanıklılık, direnç, esneklik (toparlanma gücü)
resilient: dayanıklı, dirençli, çabuk toparlanan
resistance: direniş, direnç, mukavemet
resolution: karar, azim, çözüm, çözünürlük
resonance: rezonans, tınlama, yankı, etki
resources: kaynaklar, imkanlar
respectively: sırasıyla, belirtilen sırayla
respiration: solunum, nefes alma
respite: mola, ara, soluklanma
restless: huzursuz, yerinde duramayan
restoration: restorasyon, onarma, eski haline getirme
restorative: güçlendirici, canlandırıcı, yenileyici
restore: eski haline getirmek, restore etmek, onarmak
restraining: kısıtlama, sınırlama, engelleme
restriction: kısıtlama, sınırlama
restrictive: kısıtlayıcı, sınırlayıcı
resumed: yeniden başlamış, devam edilmiş
resurgence: yeniden canlanma, diriliş, artış
retail: perakende
retaining: tutma, koruma, muhafaza etme
retaliation: misilleme, karşılık
retard: geciktirmek, yavaşlatmak
retention: tutma, alıkoyma, muhafaza, hafızada tutma
reticent: çekingen, ketum, suskun
retina: retina, ağ tabaka
retract: geri çekmek, geri almak (sözünü vb.)
retribution: ceza, intikam, öç
retrieval: geri alma, geri getirme (bilgi vb.)
retrieve: geri almak, geri getirmek (bilgi vb.)
retrospect: geriye bakış, geçmişe bakma
revelation: ifşa, açığa çıkarma, vahiy
revelry: cümbüş, alem, şenlik
revenue: gelir, hasılat
revered: saygı duyulan, hürmet edilen
reversal: tersine dönme, ters çevirme, iptal
reverses: aksilikler, başarısızlıklar, terslikler
revise: gözden geçirmek, düzeltmek, revize etmek
revised: gözden geçirilmiş, düzeltilmiş, revize edilmiş
revision: gözden geçirme, düzeltme, revizyon, tekrar
revitalise: canlandırmak, yeniden hayat vermek
revival: canlanma, diriliş, ihya
revolutionary: devrimci, devrim niteliğinde
revolutionise: devrim yapmak, kökten değiştirmek
revolutionising: devrim yapan, kökten değiştiren
revolving: dönen, döner
rewarding: tatmin edici, ödüllendirici, faydalı
rewrite: yeniden yazmak
rhetoric: retorik, hitabet sanatı, etkili konuşma
rhythm: ritim, ahenk
rhythmic: ritmik, ahenkli
rhythmically: ritmik olarak, ahenkli bir şekilde
rib: kaburga
riches: zenginlik, servet
ridicule: alay etmek, alay, istihza
rigidity: katılık, sertlik, esnemezlik
rigorous: titiz, sıkı, sert, dikkatli
ritual: ritüel, ayin, tören
rivalry: rekabet, çekişme
roamed: dolaşmış, gezinmiş
robust: sağlam, güçlü, gürbüz
rodent: kemirgen
rodents: kemirgenler
rooted: köklü, yerleşik, kök salmış
rotating: dönen, rotasyon yapan
rotation: dönme, rotasyon, nöbetleşme
roughly: kabaca, yaklaşık olarak
rounders: rounders (İngiliz top oyunu)
routinely: rutin olarak, düzenli olarak
rudimentary: temel, basit, ilkel
ruins: kalıntılar, harabeler, yıkıntılar
ruling: karar, hüküm, yöneten, iktidardaki
ruminants: geviş getirenler
rustic: kırsal, köye ait, sade
ruthless: acımasız, merhametsiz
sabotage: sabotaj, sabote etmek
sacked: kovulmuş, işten atılmış, yağmalanmış
sacred: kutsal, mukaddes
saga: destan, saga, uzun hikaye
salience: belirginlik, göze çarpma, önem
salient: belirgin, göze çarpan, en önemli
salinity: tuzluluk
saliva: salya, tükürük
salting: tuzlama
salutary: yararlı, faydalı, ders verici
sanctuary: sığınak, barınak, kutsal yer, mabet
sanitise: dezenfekte etmek, sterilize etmek
sanitation: hijyen, sağlık koruma, temizlik (kamu sağlığı)
sarcastic: alaycı, iğneleyici, kinayeli
satiated: doymuş, tatmin olmuş
saturated: doymuş, tam dolu, sırılsıklam
savannas: savanalar
savoury: tuzlu, lezzetli (tatlı olmayan)
scaffold: iskele (inşaat), yapı iskelesi
scaling: ölçeklendirme, boyutlandırma, tırmanma
scales: terazi, pullar (balık vb.), gam (müzik)
scanned: taranmış, gözden geçirilmiş
scarce: kıt, nadir, az bulunan
scarcity: kıtlık, azlık, nadirlik
scares: korkutur, korkular
scavenger: leş yiyici, çöpçü (hayvan veya insan)
sceptical: şüpheci, kuşkucu
scepticism: şüphecilik, kuşkuculuk
schizophrenia: şizofreni
scholarship: burs, ilim, bilginlik
scholars: bilginler, alimler, akademisyenler
scholarly: bilimsel, akademik, bilgince
scoff: alay etmek, küçümsemek
scorn: küçümseme, aşağılama, küçümsemek
scourges: belalar, felaketler, musibetler
scramble: aceleyle/zorlukla ilerlemek, tırmanmak, kapışmak
scrapped: hurdaya çıkarılmış, iptal edilmiş, vazgeçilmiş
scribes: yazıcılar, katipler
scriptwriters: senaristler, senaryo yazarları
scrutiny: dikkatli inceleme, titiz inceleme, denetleme
sculpt: heykel yapmak, yontmak
sculptors: heykeltıraşlar
sculptures: heykeller, yontular
seabed: deniz tabanı, deniz dibi
seafloor: deniz tabanı, deniz döşemesi
sealants: sızdırmazlık malzemeleri, dolgu macunları
secluded: tenha, gözlerden uzak, kuytu
secession: ayrılma, bölünme (federasyon vb.)
sedative: yatıştırıcı, sakinleştirici
sedentary: hareketsiz, oturarak yapılan
sediment: tortu, çökelti, sediman
seemingly: görünüşte, görünüşe göre
seismic: sismik, depremle ilgili
seize: yakalamak, ele geçirmek, el koymak
selective: seçici
selectivity: seçicilik
self-care: öz bakım, kendine iyi bakma
self-confidence: özgüven, kendine güven
self-control: öz denetim, otokontrol, irade
self-contained: bağımsız, kendi kendine yeten, içine kapanık
self-criticism: özeleştiri
self-defence: öz savunma, nefsi müdafaa
self-esteem: öz saygı, kendine değer verme
self-expression: kendini ifade etme
self-help: kişisel gelişim, kendi kendine yardım
self-image: öz imaj, benlik imajı
self-propelling: kendinden tahrikli, kendi kendine hareket eden
self-regulation: öz düzenleme
self-regulatory: öz düzenleyici
self-reliant: kendine güvenen, kendi kendine yeten
self-sufficient: kendi kendine yeten
self-transformation: kişisel dönüşüm, kendini dönüştürme
semblance: görünüş, benzeyiş, izlenim
seminal: çığır açan, öncü, temel niteliğinde
senile: bunak, bunamış
sensation: duyum, his, sansasyon
sensory: duyusal
sensor-loaded: sensör yüklü, sensörlerle donatılmış
sentenced: mahkum edilmiş, hüküm giymiş
sentimental: duygusal, hissi, içli
separatists: ayrılıkçılar, bölücüler
septicemia: septisemi, kan zehirlenmesi
sequence: sıra, dizi, sekans, ardışıklık
serial: seri, dizisel, seri (katil vb.)
serotonin: serotonin
set aside: ayırmak, bir kenara koymak, iptal etmek
setbacks: aksilikler, gerilemeler, başarısızlıklar
severely: şiddetle, ciddi biçimde, ağır bir şekilde
severity: şiddet, ciddiyet, sertlik
sewage: kanalizasyon, lağım suyu, atık su
shackles: prangalar, kelepçeler, engeller
shades: tonlar (renk), gölgeler, güneş gözlüğü
shadow: gölge, gölgelemek, takip etmek
shaking: sallama, titreme, sarsma
shallow: sığ, yüzeysel
shaman: şaman, kam
shame: utanç, ayıp, utandırmak
shamelessly: utanmazca, arsızca
shattering: parçalayan, sarsıcı, yıkıcı
shedding: dökme (yaprak, deri vb.), atma, yayma (ışık)
shellfish: kabuklu deniz ürünleri
shelter: barınak, sığınak, barındırmak, sığınmak
shield: kalkan, korumak
shifts: değişimler, kaymalar, vardiyalar
shining: parlayan, parlak
shipping: nakliye, taşımacılık (deniz yolu vb.)
shock absorber: amortisör
shrewd: zeki, kurnaz, açıkgöz
shrinking: küçülme, daralma, küçülen
shrine: türbe, kutsal yer, mabet
shrunken: küçülmüş, çekmiş, büzüşmüş
shy: utangaç, çekingen
sibling: kardeş
sickle: orak
sidewalks: kaldırımlar (ABD)
siege: kuşatma, muhasara
significant: önemli, anlamlı, dikkate değer
significantly: önemli ölçüde, belirgin şekilde
signifies: anlamına gelir, ifade eder, gösterir
signifying: anlamına gelen, ifade eden, gösteren
simultaneously: eş zamanlı olarak, aynı anda
simulate: taklit etmek, benzetimini yapmak, simüle etmek
simulated: taklit edilmiş, yapay, simüle edilmiş
simulation: simülasyon, benzetim, taklit
simultaneously: eş zamanlı olarak, aynı anda
sincerity: samimiyet, içtenlik
sinister: uğursuz, tekinsiz, kötü niyetli
situational: durumsal, duruma bağlı
skeletal: iskeletsel, iskelete ait
skeletons: iskeletler
scepticism: şüphecilik, kuşkuculuk
sketch: eskiz, taslak, taslağını çizmek
skewed: çarpık, eğri, yanlı
skillful: becerikli, hünerli, ustaca
skyrocketing: fırlayan, hızla yükselen
slab: levha, plaka, kalın dilim
slaughter: kesim (hayvan), katliam, kıyım, katletmek
slave: köle, esir
sleeplessness: uykusuzluk
slithering: sürünerek ilerleyen, kayarak giden
slogan: slogan, parola
slosh: (sıvı) çalkalanmak, lıkırdamak
sluggish: ağırkanlı, yavaş, uyuşuk
smooth: pürüzsüz, düzgün, düzeltmek
smothered: boğulmuş, üzeri örtülmüş, bastırılmış
smouldering: için için yanan, tüten, bastırılmış (duygu)
sniffles: burun çekme, hafif nezle
snowflakes: kar taneleri
snowmobiles: kar motosikletleri
soaked: sırılsıklam, iyice ıslanmış
sociable: sosyal, girişken, arkadaş canlısı
societal: toplumsal
socialise: sosyalleşmek, kaynaşmak
sociocultural: sosyokültürel
socioeconomic: sosyoekonomik
sociologists: sosyologlar, toplum bilimciler
sociopolitical: sosyopolitik, toplum-siyaset ilişkili
softening: yumuşama, yumuşatma
solely: sadece, yalnızca, tek başına
solenoid: solenoid, selenoid, bobin
solicited: istenmiş, talep edilmiş
solidarity: dayanışma
solitary: yalnız, tek başına, münzevi
solitude: yalnızlık (genellikle tercih edilen), inziva
solvent: çözücü, solvent, borcunu ödeyebilir (mali)
sombre: kasvetli, hüzünlü, loş, koyu renkli
sophistication: sofistike olma durumu, gelişmişlik, incelik, karmaşıklık
sophisticated: sofistike, gelişmiş, karmaşık, görmüş geçirmiş
sore: ağrıyan, acıyan, yara, hassas (konu)
sought: aranan, istenen, talep edilen (seek fiilinin past participle)
sovereignty: egemenlik, hükümranlık
sowing: ekme, tohum ekme
spanned: kapsadı, uzandı, süresince devam etti
spans: kapsar, uzanır, süresince devam eder, açıklık, aralık (köprü vb.)
sparked: kıvılcım çıkardı, başlattı, tetikledi
sparking: kıvılcım çıkaran, başlatan, tetikleyen
sparsely: seyrek olarak, aralıklı olarak
spawning: yumurtlama (balık vb.), ortaya çıkarma, türetme (mecazi)
specialisation: uzmanlaşma, ihtisaslaşma
specialised: uzmanlaşmış, özel, ihtisaslaşmış
species: türler (biyoloji)
specification: şartname, belirtim, özellik, spesifikasyon
specifics: ayrıntılar, detaylar, özellikler
specimens: örnekler, numuneler (genellikle bilimsel)
spectacle: görünüM, manzara, gösteri, (çoğul) gözlük
spectacular: muhteşem, görkemli, olağanüstü
spectators: seyirciler, izleyiciler
spectrum: spektrum, tayf, yelpaze (geniş çeşitlilik)
speculate: spekülasyon yapmak, tahminde bulunmak, kafa yormak
speculated: spekülasyon yaptı, tahminde bulundu
speculation: spekülasyon, tahmin, kurgu
spew: püskürtmek, kusmak, fışkırtmak
spherical: küresel, küre şeklinde
spices: baharatlar
spinal: omurga ile ilgili, spinal
spindle: iğ, mil, eksen
spindly: ince ve uzun, çelimsiz
spinning: dönen, eğirme, baş dönmesi
spirited: canlı, enerjik, hevesli, cesur
spiritual: manevi, ruhsal
spitting: tükürme, tüküren
splash: sıçratmak, sıçramak, sıçrama sesi/izi
split: bölmek, ayırmak, yarmak, bölünme, ayrılık, yarık
splinter: kıymık, küçük parça, parçalanmak, bölünmek
spoilage: bozulma (gıda vb.), çürüme
sponsors: sponsorlar, destekleyiciler
spontaneity: kendiliğindenlik, doğallık, spontanelik
spontaneous: kendiliğinden olan, spontane, anlık
sporadically: ara sıra, tek tük, düzensiz olarak
spot: nokta, benek, leke, yer, mekan, fark etmek, görmek
spotless: lekesiz, tertemiz
spotlight: spot ışığı, ilgi odağı
spouse: eş (karı veya koca)
sprawling: yayılmış, gelişigüzel yayılan, dağınık
spreads: yayılır, dağılır, sürmek (ekmeğe vb.), yayılma, dağılma
springboards: sıçrama tahtası, başlangıç noktası, dayanak
sprinkling: serpme, serpiştirme, az miktar
sprint: kısa mesafe koşusu, depar, hızla koşmak
sprouts: filizlenir, filiz verir, filizler
spruce: ladin (ağaç), şık, temiz, şıklaştırmak
spurred: teşvik edilmiş, hızlandırılmış, mahmuzlu
spur: mahmuz, teşvik, dürtü, teşvik etmek, hızlandırmak
squint: şaşı bakmak, gözlerini kısmak, şaşılık
squirt: fışkırtmak, püskürtmek, fışkırma
stability: istikrar, denge, kararlılık
stabilisation: stabilizasyon, istikrara kavuşturma, dengeleme
stabilised: stabilize edilmiş, istikrara kavuşturulmuş, dengelenmiş
stagnant: durgun, hareketsiz, gelişmeyen
stain: leke, boyamak, lekelemek
stake: kazık, pay, hisse, risk, bahis, tehlikeye atmak
stalactites: sarkıtlar (mağara)
stalagmites: dikitler (mağara)
stamina: dayanıklılık, direnç, güç
stamp: pul, damga, mühür, damgalamak, ayakla vurmak
stance: duruş, tavır, tutum, görüş
standardisation: standardizasyon, standartlaştırma
standardized: standartlaştırılmış, standardize edilmiş
standpoint: bakış açısı, görüş noktası
staple: temel gıda maddesi, ana ürün, zımba teli, zımbalamak
staples: temel gıda maddeleri, ana ürünler, zımba telleri
starvation: açlık, açlıktan ölme
stately: heybetli, görkemli, ağırbaşlı
static: statik, durağan, parazit (radyo vb.)
statistical: istatistiksel
statues: heykeller
stature: boy, endam, itibar, önem, mertebe
status: statü, durum, konum, hal
staunch: sadık, sağlam, güvenilir, (kanamayı) durdurmak
stave off: savuşturmak, önlemek, geçiştirmek
steadily: sürekli olarak, istikrarlı bir şekilde, durmadan
stealth: gizlilik, sinsilik, fark ettirmeme
stealthily: gizlice, sinsice, sessizce
stellar: yıldızlarla ilgili, yıldızsal, mükemmel, olağanüstü (mecazi)
stereotype: kalıp yargı, basmakalıp düşünce, klişe
stereotypes: kalıp yargılar, basmakalıp düşünceler, klişeler
stereotypic: kalıp yargısal, basmakalıp
stereotypical: kalıp yargısal, basmakalıp, klişe
sterile: steril, kısır, verimsiz, arınık
sterilising: sterilize eden, kısırlaştıran
stimulating: uyarıcı, teşvik edici, canlandırıcı
stimulants: uyarıcılar, uyarıcı maddeler
stimulate: uyarmak, teşvik etmek, canlandırmak
stimuli: uyaranlar, uyarıcılar (stimulus'un çoğulu)
stimulus: uyaran, uyarıcı, teşvik
stipulation: şart, koşul, hüküm
stipulations: şartlar, koşullar, hükümler
stock: stok, mevcut mal, hisse senedi, soy, köken, hayvan stoku, et suyu
stoic: stoacı, duygularını belli etmeyen, metanetli
stoicism: stoacılık, metanet, duygularını kontrol etme
stonecutter: taş ustası, taş kesici
storage: depolama, saklama, depo
storing: depolama, saklama
strains: türler, suşlar (bakteri/virüs), gerginlik, zorlanma, nağmeler
strand: tel, iplik, (saç) tutamı, kıyı, sahil, mahsur kalmak/bırakmak
strands: teller, iplikler, (saç) tutamları
strata: tabakalar, katmanlar (stratum'un çoğulu)
stratosphere: stratosfer
stream: akarsu, dere, çay, akış, akım, yayın (internet)
streamline: modernleştirmek, kolaylaştırmak, aerodinamik hale getirmek
strenuous: yorucu, zahmetli, gayretli
stride: uzun adımlarla yürümek, uzun adım, ilerleme, gelişme
striking: çarpıcı, dikkat çekici, göze çarpan
stringent: katı, sıkı, sert (kural, yasa vb.)
strip: şerit, bant, soymak, çıkarmak
strive: çabalamak, gayret etmek, uğraşmak
stroll: gezinmek, aylak aylak dolaşmak, gezinti
stubborn: inatçı, dik başlı
studded: çivili, zımbalı, (-ile) süslü/kaplı
stunning: büyüleyici, çarpıcı, nefes kesici, sersemletici
stupefied: sersemlemiş, şaşkına dönmüş, uyuşmuş
stupor: şuur bulanıklığı, uyuşukluk, sersemlik
sturdy: sağlam, dayanıklı, gürbüz
stylistic: üslupsal, biçemsel, stilistik
stylised: üsluplaştırılmış, stilize edilmiş
subatomic: atom altı
subconscious: bilinçaltı
subcultural: alt kültürel
subdivide: alt bölümlere ayırmak, tekrar bölmek
subdue: bastırmak, boyun eğdirmek, kontrol altına almak, hafifletmek (renk, ses)
subdued: bastırılmış, kontrol altına alınmış, sakin, sessiz, hafif (renk, ses)
subjective: öznel, subjektif
subjectivity: öznellik, subjektiflik
subjugate: boyun eğdirmek, egemenlik altına almak
sublime: yüce, ulu, muhteşem
submerged: suya batmış, dalmış
submission: teslimiyet, boyun eğme, sunma, ibraz etme (belge vb.)
submissive: itaatkar, boyun eğen
subnational: ulusal altı, bölgesel
subordinate: ast, alt düzeyde olan, ikincil, tabi, tabi kılmak
subsequent: sonraki, müteakip, izleyen
subsequently: sonradan, akabinde, daha sonra
substantial: önemli, büyük, hatırı sayılır, sağlam, dayanıklı, besleyici
substantially: önemli ölçüde, büyük ölçüde, esasen
substitute: yedek, vekil, yerine geçen şey/kimse, yerine geçmek, yerine kullanmak
substitution: yerine geçme, ikame, değiştirme
subterranean: yer altı
subtle: ince, zarif, ustaca, hemen göze çarpmayan, anlaşılamayan
subtlety: incelik, nüans, ustalık
subtypes: alt tipler
subvert: yıkmak, devirmek, düzenini bozmak, sarsmak
succession: ardıllık, veraset, birbirini izleme, sıra
successive: ardışık, birbirini izleyen, peş peşe gelen
succumbed: yenik düştü, boyun eğdi, dayanamadı (-e)
succulents: sukulentler, etli bitkiler
suffered: acı çekti, maruz kaldı, zarar gördü
suffocation: boğulma (nefessizlikten)
suffrage: oy hakkı
sullen: somurtkan, aksi, suratsız
summarise: özetlemek
summons: celp, mahkeme çağrısı, çağırma, davet
superimposed: üst üste bindirilmiş, üzerine konmuş
supernatural: doğaüstü
supersede: yerini almak, geçersiz kılmak
superstition: batıl inanç, hurafe
superstitious: batıl inançlı
supervise: denetlemek, gözetmek, nezaret etmek
supervision: denetim, gözetim, nezaret
supplanted: yerini almış, alt etmiş
supplementary: ek, tamamlayıcı, ilave
supplier: tedarikçi, sağlayıcı
supportive: destekleyici, yardımcı
suppose: varsaymak, farz etmek, sanmak
suppress: bastırmak, önlemek, örtbas etmek, sindirmek
suppression: bastırma, önleme, örtbas etme, sindirme
supremacy: üstünlük, egemenlik, hakimiyet
surge: ani artış, yükselme, dalgalanma, hücum etmek, dalgalanmak
surpassing: üstün, aşan, geçen
surrendering: teslim olma, bırakma
surrogate: vekil, taşıyıcı (anne vb.), yerine geçen
surveillance: gözetim, izleme, nezaret
susceptible: duyarlı, hassas, (-e) açık, yatkın
suspect: şüpheli, sanık, şüphelenmek, kuşkulanmak
suspends: askıya alır, erteler, durdurur, asar
suspension: askıya alma, erteleme, durdurma, süspansiyon (araç), asılı kalma
suspicion: şüphe, kuşku, zan
sustainable: sürdürülebilir, devam ettirilebilir
sustainability: sürdürülebilirlik
sustained: sürekli, devamlı, aralıksız
sustenance: besin, gıda, geçim, rızık
swaddling: kundaklama, kundak bezi
swaying: sallanma, salınma
sweeping: geniş kapsamlı, genel, süpürme, ezici (zafer)
sweltering: bunaltıcı sıcak, çok sıcak
swift: hızlı, çabuk, süratli, ebabil kuşu
swollen: şişmiş, şişkin
symbolic: sembolik, simgesel
symbols: semboller, simgeler
symmetry: simetri, bakışım
sympathetic: sempatik, anlayışlı, duygudaş, sempatik (sinir sistemi)
sympathy: sempati, şefkat, merhamet, anlayış, duygudaşlık
symptoms: belirtiler, semptomlar, arazlar
symptomatic: semptomatik, belirti gösteren, belirtisi olan
simultaneously: eş zamanlı olarak, aynı anda
synchronise: senkronize etmek, eş zamanlamak, eşleştirmek
sync: senkronizasyon, eşitleme, senkronize etmek
syndrome: sendrom
synonymous: eş anlamlı, sinonim
synopsis: özet, kısaltma, sinopsis
synthesis: sentez, bireşim
synthesiser: sentezleyici, sentezör (müzik aleti)
synthetic: sentetik, yapay
syphilis: sifiliz, frengi
tactful: düşünceli, ince, nazik, diplomatik
tactics: taktikler
tactile: dokunsal, dokunma ile ilgili
tailored: özel olarak hazırlanmış, uyarlanmış, terzi işi
tangible: somut, elle tutulur, maddi
tankers: tankerler
tantrums: öfke nöbetleri, huysuzluk krizleri (genellikle çocuk)
tap into: faydalanmak, yararlanmak, -den yararlanmak
targeted: hedeflenmiş, hedef alınan
tardiness: gecikme, geç kalma, yavaşlık
taxonomy: taksonomi, sınıflandırma bilimi
teasing: takılma, kızdırma, alay etme
teem: kaynamak (-ile dolu olmak), dolu olmak
teeming: kaynayan, (-ile) dolu
telecommute: uzaktan çalışmak, evden çalışmak
telepathy: telepati, düşünce aktarımı
temperament: mizaç, huy, yaradılış
temperate: ılıman (iklim), ölçülü, ılımlı (davranış)
tempo: tempo, hız (müzik, hareket)
temporal: zamansal, geçici, şakakla ilgili
temptation: ayartma, baştan çıkarma, cazibe, günaha davet
temptations: ayartmalar, baştan çıkarmalar, cazibeler
tempting: cazip, çekici, baştan çıkarıcı
tendency: eğilim, meyil, temayül
tender: yumuşak, hassas, şefkatli, teklif (ihale), sunmak, vermek
tendons: tendonlar, kirişler
tenet: ilke, prensip, öğreti, akide
tense: gergin, sinirli, zaman (dilbilgisi)
tensile: gerilme, çekme (dayanımı vb.)
termination: sona erme, bitiş, fesih, sonlandırma
terminology: terminoloji, terimler, terim bilgisi
terrain: arazi, bölge (coğrafi)
terrestrial: karasal, yeryüzüne ait, dünyevi
territorial: bölgesel, toprakla ilgili, bölgesine düşkün (hayvan)
territories: bölgeler, topraklar, araziler
terror: terör, dehşet, korku
tertiary: üçüncül, üçüncü dereceden
testament: vasiyetname, kanıt, delil, Ahit (İncil)
testified: tanıklık etti, ifade verdi
testify: tanıklık etmek, ifade vermek, doğrulamak
testimony: tanıklık, ifade, şahitlik
texture: doku, yapı, yüzey hissi
thaw: erimek (buz, kar), çözülmek, yumuşamak (ilişki vb.)
theatrical: teatral, tiyatro ile ilgili, yapmacık, abartılı
thematic: tematik, konuyla ilgili
theoretical: teorik, kuramsal
theorised: teori üretti, kuramlaştırdı
thereafter: ondan sonra, akabinde, daha sonra
thereby: böylece, bu suretle, dolayısıyla
thereof: onun, ona ait (genellikle resmi/hukuki dilde)
thermal: termal, ısıl, ısı ile ilgili
thermometer: termometre, sıcaklıkölçer
therapeutic: terapötik, tedavi edici, iyileştirici
thermoregulation: termoregülasyon, ısı düzenlemesi
thesis: tez, iddia, sav
thigh: uyluk, but
thorn: diken
thorough: eksiksiz, tam, detaylı, özenli
thoroughly: tamamen, etraflıca, iyice, eksiksiz olarak
thought-provoking: düşündürücü
thoughtless: düşüncesiz, kaba, anlayışsız
thrashing: dövme, dayak, çırpınma, ezici yenilgi
thread: iplik, tel, konu (forum vb.), iplik geçirmek (iğneye vb.)
threading: iplik geçirme, diş açma (vida), iş parçacığı oluşturma (bilgisayar)
threat: tehdit, tehlike
threatening: tehdit edici, tehditkar
threshold: eşik, sınır, başlangıç noktası
thrive: gelişmek, serpilmek, başarılı olmak
throes: şiddetli sancı, can çekişme (genellikle çoğul: in the throes of - sancıları içinde)
thrombosis: tromboz, damar tıkanıklığı (pıhtı ile)
throng: kalabalık, izdiham
throttle: gaz kelebeği, gaz kolu, kısmak, boğmak (motor vb.)
throw away: atmak, çöpe atmak, boşa harcamak
thrust: itme kuvveti, itiş, hamle, itmek, sokmak
thwart: engellemek, köstek olmak, boşa çıkarmak
tidal: gelgit ile ilgili, medcezirsel
tides: gelgitler, medcezirler
tidings: haberler (genellikle eski kullanım)
till: kadar (-e kadar), toprağı işlemek, sürmek, kasa (para)
tilling: toprağı işleme, sürme
timber: kereste, tomruk
timberlands: kerestelik ormanlar, ormanlık araziler
timely: zamanında, vaktinde yapılmış, uygun zamanlı
timepieces: saatler (genel olarak zaman ölçen aletler)
tinkering: kurcalama, üstünkörü tamir etme, oynama
tissue: doku (biyolojik), kağıt mendil, ince kağıt
token: jeton, simge, belirti, nişan
tolerable: katlanılabilir, dayanılabilir, hoş görülebilir
tolerance: hoşgörü, tolerans, dayanıklılık (teknik)
tolerant: hoşgörülü, toleranslı
tolerate: hoş görmek, katlanmak, tahammül etmek, müsamaha göstermek
topography: topografya, arazi yapısı
topography: topografya, arazi yapısı
torment: işkence, eziyet, büyük acı, işkence etmek
torpedo: torpido, torpil, torpillemek
torrential: sağanak halinde, şiddetli (yağmur vb.)
torture: işkence, eziyet, işkence etmek
tourism: turizm
toxic: toksik, zehirli
toxins: toksinler, zehirler
trace: iz, belirti, eser, izini sürmek, takip etmek, kökenini bulmak
track: iz, yol, patika, ray, pist, takip etmek, izlemek
tractor: traktör
tradition: gelenek, anane
tragedy: trajedi, facia, feci olay
tragic: trajik, feci, acıklı
trait: özellik, nitelik, karakter vasfı
trajectory: yörünge, gidişat, mermi yolu
tranquil: sakin, huzurlu, dingin
transatlantic: transatlantik, Atlantik aşırı
transcend: aşmak, üstüne çıkmak, üstün olmak
transcription: transkripsiyon, yazıya dökme, kopyalama (genetik, müzik)
transcribe: yazıya dökmek, kopyasını çıkarmak, transkripsiyonunu yapmak
transference: aktarım, transfer, devir
transform: dönüştürmek, değiştirmek, transformasyon yapmak
transformation: dönüşüm, transformasyon, değişim
transfusion: kan nakli, transfüzyon
transgression: ihlâl, suç, günah, (sınırı) aşma
transient: geçici, fani, kalıcı olmayan
transit: geçiş, transit, taşıma
transition: geçiş, intikal, değişim dönemi
transitional: geçiş niteliğinde, geçici
transmission: iletim, aktarma, vites kutusu (araba), bulaşma (hastalık)
transmit: iletmek, aktarmak, yayınlamak, bulaştırmak
transmitter: verici, aktarıcı
transmitters: vericiler, aktarıcılar
transplanted: nakledilmiş, (organ vb.) transplante edilmiş
transposition: transpozisyon, yer değiştirme, aktarma (müzik)
trauma: travma, ruhsal sarsıntı, yara
traumatic: travmatik, sarsıcı
traversed: geçilmiş, aşılmış, kat edilmiş
treacherous: hain, güvenilmez, tehlikeli (zemin, hava vb.)
treaties: antlaşmalar, muahedeler
trembling: titreyen, ürperen
tremendous: muazzam, çok büyük, olağanüstü, harika
trench: hendek, siper
trends: eğilimler, trendler, akımlar
trial-and-error: deneme yanılma
tribal: kabileye ait, aşiretsel
tribesmen: kabile üyeleri, aşiret mensupları
tribunals: mahkemeler, yargı kurulları
tribute: haraç, vergi, saygı ifadesi, övgü
trick: hile, numara, oyun, aldatmaca
trickle: sızmak, damlamak, yavaş yavaş akmak
trickster: hilekar, düzenbaz, üçkağıtçı
trigger: tetik, tetiklemek, başlatmak, neden olmak
trillion: trilyon
trio: üçlü, trio
triumph: zafer, başarı, galibiyet, zafer kazanmak
trivial: önemsiz, değersiz, cüzi, sıradan
tropics: tropikler, dönenceler arası bölge
troubleshoot: sorun gidermek, arıza aramak/bulmak
truancy: okuldan kaçma, devamsızlık
trustworthy: güvenilir, itimada layık
trypanosome: tripanosoma (bir parazit türü)
tundra: tundra (kutupaltı bitki örtüsü)
tune in: (radyo/tv) ayarlamak, dinlemeye/izlemeye başlamak
turbulence: türbülans, çalkantı, kargaşa
turbulent: çalkantılı, türbülanslı, kargaşalı, asi
turmoil: kargaşa, karışıklık, hengame
tusk: fildişi, (hayvanın) uzun sivri dişi
tutelage: vesayet, himaye, gözetim altında eğitim
tutor: özel öğretmen, eğitmen, özel ders vermek
twin: ikiz
twitches: seğirmeler, tikler, ani kasılmalar
typical: tipik, karakteristik, özgü
typically: tipik olarak, genellikle
tyranny: tiranlık, zorbalık, zulüm yönetimi
ultimate: nihai, son, en üstün, temel
ultimately: sonunda, nihayetinde, eninde sonunda
unambiguous: açık, net, belirsiz olmayan, tek anlamlı
unambiguously: açıkça, net bir şekilde, belirsizliğe yer bırakmadan
unappetising: iştah açıcı olmayan, sevimsiz
unbearably: dayanılmaz bir şekilde, çekilmez derecede
uncharted: keşfedilmemiş, haritası çıkarılmamış, bilinmeyen
uncommon: nadir, ender, alışılmadık
uncomplicated: karmaşık olmayan, basit, kolay
unconscious: bilinçsiz, baygın, bilinçaltı
unconsciously: bilinçsizce, farkında olmadan
undeniable: inkar edilemez, tartışılmaz
undeniably: inkar edilemez bir şekilde, şüphesiz
underdeveloped: az gelişmiş
underestimate: hafife almak, küçümsemek, azımsamak
undergone: geçirmiş, maruz kalmış, yaşamış
underlie: altında yatmak, temelini oluşturmak, -nın altında bulunmak
underlying: altında yatan, temelindeki, asıl
undermine: zayıflatmak, baltalamak, altını oymak
undernourished: yetersiz beslenmiş
undisputed: tartışmasız, kesin, itirazsız kabul edilen
undisputed: tartışmasız, kesin, itirazsız kabul edilen
undoubtedly: şüphesiz, kuşkusuz, muhakkak
unethical: etik olmayan, ahlaka aykırı
unexpectedly: beklenmedik bir şekilde, aniden
unfair: adaletsiz, haksız
unfamiliar: yabancı, aşina olmayan, bilinmeyen
unfavourable: olumsuz, elverişsiz, aleyhte
unfeasible: uygulanamaz, yapılamaz, mümkün olmayan
unfold: açılmak, serilmek, ortaya çıkmak, gelişmek
unforeseen: öngörülemeyen, beklenmedik
unfounded: asılsız, temelsiz, dayanaksız
unification: birleşme, birleştirme
uniformity: tekdüzelik, yeknesaklık, aynılık
unifying: birleştirici
unimaginably: hayal edilemez derecede, akıl almaz biçimde
uninformed: bilgisiz, habersiz
unintentional: kasıtsız, istemeden yapılan
unintentionally: kasıtsız olarak, istemeden
unique: eşsiz, benzersiz, tek, özgün
uniqueness: eşsizlik, benzersizlik, teklik, özgünlük
unison: uyum, ahenk, birlik (in unison: birlikte, aynı anda)
unjust: adaletsiz, haksız
unjustifiable: haklı gösterilemez, mazur görülemez, yersiz
unlicensed: ruhsatsız, lisanssız, izinsiz
unlimited: sınırsız, limitsiz
unnoticed: fark edilmemiş, gözden kaçmış
unparallelled: eşsiz, benzersiz, emsalsiz
unprecedented: eşi görülmemiş, benzeri yaşanmamış, emsalsiz
unpredictable: öngörülemez, tahmin edilemez, değişken
unpredictability: öngörülemezlik, tahmin edilemezlik
unprofitable: kârsız, kazançsız, verimsiz
unreasonable: mantıksız, makul olmayan, aşırı
unrelated: ilişkisiz, alakasız, bağlantısız
unremarkable: dikkate değer olmayan, sıradan, göze çarpmayan
unresolved: çözülmemiş, halledilmemiş, karara bağlanmamış
unresponsive: tepkisiz, duyarsız, karşılık vermeyen
unrest: huzursuzluk, kargaşa, rahatsızlık
unrivalled: rakipsiz, eşsiz
unsatisfactory: tatmin edici olmayan, yetersiz, memnuniyetsiz bırakan
unsettling: huzursuz edici, tedirgin edici, rahatsız edici
unsophisticated: saf, basit, tecrübesiz, karmaşık olmayan
unstable: istikrarsız, kararsız, dengesiz
unstoppable: durdurulamaz
unsustainable: sürdürülemez
untapped: kullanılmamış, el değmemiş, işlenmemiş (kaynak vb.)
until: kadar (-e kadar), -inceye dek
unusual: alışılmadık, olağandışı, nadir
unveil: örtüsünü açmak, açığa çıkarmak, ortaya sermek
unvaryingly: değişmeksizin, hep aynı şekilde
unwavering: sarsılmaz, tereddütsüz, kararlı
unwelcome: istenmeyen, hoş karşılanmayan
unwittingly: farkında olmadan, istemeden, bilmeyerek
unworthy: layık olmayan, değersiz (-e layık olmayan)
upbringing: yetiştirilme tarzı, terbiye
updraughts: yukarı doğru hava akımları
uphold: desteklemek, onaylamak, sürdürmek, savunmak (karar, yasa vb.)
upholders: destekçiler, savunucular
upkeep: bakım, idame, muhafaza (masrafı)
uplifting: moral veren, canlandırıcı, yüceltici
upright: dik, dikey, dürüst, namuslu
upsurge: ani artış, kabarma, yükseliş
urbanisation: kentleşme, şehirleşme
urbanised: kentleşmiş, şehirleşmiş
urgency: aciliyet, ivedilik
urgently: acil olarak, ivedilikle
urinary: idrarla ilgili, üriner
utilisation: kullanım, faydalanma, yararlanma
utilize: kullanmak, faydalanmak, yararlanmak
utterly: tamamen, bütünüyle, son derece
vacate: boşaltmak, tahliye etmek, terk etmek
vacuum: vakum, boşluk, elektrikli süpürge
validate: doğrulamak, geçerli kılmak, onaylamak
validity: geçerlilik, geçerlik süresi
vandalism: vandalizm, barbarlık, kasten mala zarar verme
vanish: gözden kaybolmak, yok olmak, ortadan kalkmak
vanished: gözden kaybolmuş, yok olmuş
vaporise: buharlaşmak, buharlaştırmak
vapour: buhar, buğu
variability: değişkenlik, kararsızlık
variable: değişken, kararsız, değişken (isim)
variations: varyasyonlar, çeşitlemeler, değişiklikler
varied: çeşitli, değişik, farklı
vast: geniş, çok büyük, engin
vastly: çok, büyük ölçüde, oldukça
vastness: genişlik, büyüklük, enginlik
vellum: parşömen (özellikle dana derisinden)
vengeful: intikamcı, kinci
venom: zehir (özellikle yılan/böcek), kin, hınç
venomous: zehirli (hayvan vb.)
venture: girişim, macera, riskli iş, cüret etmek, tehlikeye atılmak
ventured: cüret etti, tehlikeye atıldı, girişti
verbalising: söze dökme, sözlü ifade etme
verdict: karar, hüküm (mahkeme), jüri kararı
verification: doğrulama, teyit etme, tasdik
versatility: çok yönlülük, beceriklilik, değişkenlik
vertebrate: omurgalı
vessel: kap, tekne, gemi, damar (kan)
viable: yaşayabilir, uygulanabilir, geçerli
vibrant: canlı, enerjik, titreşen, parlak (renk)
vibrations: titreşimler
vice versa: tersi de geçerli, aksi de doğru, karşılıklı olarak
vicinity: civar, çevre, yakınlar (in the vicinity of: civarında)
victimisation: kurban etme, mağdur etme, haksızlığa uğratma
victims: kurbanlar, mağdurlar
viewpoint: bakış açısı, görüş noktası
vigilance: uyanıklık, tetikte olma, ihtiyat
vigour: güç, dinçlik, canlılık, şevk
vigorous: güçlü, dinç, enerjik, coşkulu
vindicated: aklanmış, haklı çıkmış, doğrulanmış
violation: ihlal, çiğneme, tecavüz
virtual: sanal, neredeyse, fiili, esasen
virtually: neredeyse, hemen hemen, fiilen, sanal olarak
virtue: erdem, fazilet, meziyet, avantaj, yarar (by virtue of: sayesinde)
virtuous: erdemli, faziletli, namuslu
viscosity: viskozite, akmazlık, ağdalılık
visibility: görüş mesafesi, görünürlük
visible: görünür, görülebilir, belli
visionary: vizyoner, ileri görüşlü, hayalperest
visualise: gözünde canlandırmak, görselleştirmek
vividly: canlı bir şekilde, parlak bir şekilde, net olarak
vocational: mesleki, mesleğe yönelik
volatile: uçucu, değişken, kararsız, gelgeç (mizaç)
voluntarily: gönüllü olarak, isteyerek
voluminous: hacimli, çok büyük, dolgun
voluminousness: hacimlilik, büyüklük
vowed: yemin etmiş, ant içmiş
vulnerability: kırılganlık, savunmasızlık, hassasiyet
vulnerable: kırılgan, savunmasız, hassas, saldırıya açık
wading: suda yürüme(k)
wane: azalmak, küçülmek (ay), zayıflamak, sönmek
wandering: dolaşan, gezgin, başıboş, dalgın
wanton: sebepsiz (şiddet vb.), ahlaksız, sefih, kasten yapılan kötülük
warfare: savaş, harp, mücadele
warlike: savaşçı, savaşkan, savaşa meyilli
warrant: izin belgesi, yetki, ruhsat, gerekçe, sebep, garanti etmek, gerektirmek
watershed: dönüm noktası, su bölümü çizgisi, havza
waterways: suyolları (nehir, kanal vb.)
wavelengths: dalga boyları
wavering: tereddüt eden, kararsız, dalgalanan
wear away: aşındırmak, yıpratmak, zamanla yok etmek/olmak
weigh up: tartmak (mecazi), değerlendirmek, ölçüp biçmek
well-being: refah, esenlik, iyilik hali
well-documented: iyi belgelenmiş, kanıtları sağlam
well-established: köklü, yerleşmiş, iyi kurulmuş
well-heeled: zengin, varlıklı, hali vakti yerinde
whereas: oysa, halbuki, -diği halde
whereby: vasıtasıyla, yoluyla, sayesinde
whims: kaprisler, geçici hevesler, tuhaflıklar
wholehearted: içten, samimi, canı gönülden
wholesome: sağlıklı, sağlığa yararlı, besleyici, ahlaken iyi
wield: kullanmak (güç, silah, alet), sahip olmak ve kullanmak
wilderness: yaban hayatı alanı, vahşi doğa, el değmemiş bölge
widespread: yaygın, geniş çapta
wilt: solmak, pörsümek
window dressing: göstermelik iş, göz boyama, vitrin düzenlemesi
withdrawal: geri çekilme, para çekme (banka), vazgeçme, içe kapanma
withstand: dayanmak, karşı koymak, direnmek (-e)
workout: antrenman, egzersiz, idman
worrisome: endişe verici, kaygılandırıcı
worthwhile: zahmete değer, yapmaya değer, faydalı
wreaths: çelenkler
yielded: verdi, sağladı, ürün verdi, teslim oldu, boyun eğdi
zealous: gayretli, hevesli, şevkli, coşkulu
zenith: zirve, doruk noktası, başucu noktası (gökbilim)
zipped: fermuarı çekilmiş, sıkıştırılmış (dosya)

--- TELEGRAM: DREAMPIUV ---
--- TELEGRAM CHANNEL: ENGLISHAFL
--- DNE ---
